"a" = (/turf/template_noop,/area/template_noop)
"B" = (/turf/open/floor/plating/polovich/way/dirtyd,/area/template_noop)

(1,1,1) = {"
aaaaaaa
aBaBaBa
aaBBBaa
aBBBBBa
aaBBBaa
aBaBaBa
aaaaaaa
"}
