"aa" = (/turf/open/floor/plating/polovich/dirt/blueee,/area/maintenance/polovich/forest)
"ab" = (/turf/closed/wall/purple/nocling,/area/maintenance/polovich/forest)
"ac" = (/turf/closed/wall/purple/nocling,/area/maintenance/polovich/catacombs)
"ad" = (/turf/closed/wall/darkrock/nocling,/area/maintenance/polovich/catacombs)
"ae" = (/turf/closed/wall/darkrock,/area/maintenance/polovich/catacombs)
"af" = (/obj/structure/closet/crate/wooden,/obj/item/melee/hehe/pickaxe/iron,/obj/item/melee/hehe/pickaxe/iron,/turf/open/floor/plating/polovich/dirt/blueee,/area/maintenance/polovich/catacombs)
"ag" = (/turf/open/floor/plating/polovich/dirt/blueee,/area/maintenance/polovich/catacombs)
"ah" = (/obj/structure/lampwall/service/directional/north,/turf/open/floor/plating/polovich/dirt/blueee,/area/maintenance/polovich/catacombs)
"ai" = (/obj/structure/stairs/north,/turf/open/floor/plating/polovich/dirt/blueee,/area/maintenance/polovich/catacombs)
"aj" = (/obj/structure/closet/crate/wooden,/obj/item/lamp,/obj/item/lamp,/obj/item/lamp,/obj/item/lamp,/turf/open/floor/plating/polovich/dirt/blueee,/area/maintenance/polovich/catacombs)
"ak" = (/obj/structure/closet/crate/wooden,/obj/item/organ/spleen/vilir,/obj/item/organ/spleen/vilir,/obj/item/organ/spleen/vilir,/obj/item/organ/spleen/vilir,/turf/open/floor/plating/polovich/dirt/blueee,/area/maintenance/polovich/catacombs)
"al" = (/obj/structure/toilet{dir = 4},/turf/open/floor/plating/polovich/dirt/blueee,/area/maintenance/polovich/catacombs)
"am" = (/obj/structure/flora/ausbushes/zarosli/midnight,/turf/open/floor/plating/polovich/dirt/blueee,/area/maintenance/polovich/catacombs)
"an" = (/obj/structure/lampstand/fireholder,/turf/open/floor/plating/polovich/dirt/blueee,/area/maintenance/polovich/catacombs)
"ao" = (/obj/structure/closet/crate/wooden,/obj/item/storage/backpack/baggy,/obj/item/storage/backpack/baggy,/obj/item/storage/backpack/baggy,/obj/item/storage/backpack/baggy,/turf/open/floor/plating/polovich/dirt/blueee,/area/maintenance/polovich/catacombs)
"ap" = (/obj/structure/bed/maint,/turf/open/floor/plating/polovich/dirt/blueee,/area/maintenance/polovich/catacombs)
"aq" = (/obj/structure/bed/maint,/obj/effect/landmark/start/slave,/turf/open/floor/plating/polovich/dirt/blueee,/area/maintenance/polovich/catacombs)
"ar" = (/obj/structure/flora/tree/evil,/turf/open/floor/plating/polovich/roots,/area/maintenance/polovich/catacombs)
"as" = (/obj/structure/lampstand,/turf/open/floor/plating/polovich/dirt/blueee,/area/maintenance/polovich/catacombs)
"at" = (/obj/structure/stone_eater,/turf/open/floor/plating/polovich/dirt/blueee,/area/maintenance/polovich/catacombs)
"au" = (/obj/structure/stone_mixer,/turf/open/floor/plating/polovich/dirt/blueee,/area/maintenance/polovich/catacombs)
"av" = (/turf/closed/wall/purple/nocling,/area/maintenance/polovich/village)
"aw" = (/obj/structure/lampstand,/turf/open/floor/plating/polovich/greenstone,/area/maintenance/polovich/village)
"ax" = (/obj/structure/stairs/north,/turf/open/floor/plating/polovich/greenstone,/area/maintenance/polovich/village)
"ay" = (/obj/structure/closet/secure_closet/freezer/fridge,/obj/item/stack/medical/mesh,/turf/open/floor/plating/polovich/greenstone,/area/maintenance/polovich/village)
"az" = (/obj/structure/column,/turf/open/floor/plating/polovich/greenstone,/area/maintenance/polovich/village)
"aA" = (/turf/open/floor/plating/polovich/greenstone,/area/maintenance/polovich/village)
"aB" = (/obj/structure/closet/secure_closet/freezer/fridge,/obj/item/stack/medical/gauze/twelve,/turf/open/floor/plating/polovich/greenstone,/area/maintenance/polovich/village)
"aC" = (/obj/structure/closet/secure_closet/freezer/fridge,/obj/item/stack/medical/nanopaste/xap/two,/turf/open/floor/plating/polovich/greenstone,/area/maintenance/polovich/village)
"aD" = (/obj/structure/closet/secure_closet/freezer/fridge,/obj/item/stack/medical/suture,/obj/item/food/grown/lifebloodcherries,/turf/open/floor/plating/polovich/greenstone,/area/maintenance/polovich/village)
"aE" = (/obj/structure/closet/secure_closet/freezer/fridge,/obj/item/food/grown/bluecherries/super,/obj/item/food/grown/bluecherries/super,/turf/open/floor/plating/polovich/greenstone,/area/maintenance/polovich/village)
"aF" = (/obj/structure/closet/secure_closet/freezer/fridge,/obj/item/reagent_containers/pill/hexacrocin,/obj/item/reagent_containers/pill/hexacrocin,/obj/item/reagent_containers/pill/hexacrocin,/turf/open/floor/plating/polovich/greenstone,/area/maintenance/polovich/village)
"aG" = (/obj/structure/closet/secure_closet/freezer/fridge,/obj/item/reagent_containers/pill/hexacrocin,/obj/item/reagent_containers/pill/hexacrocin,/turf/open/floor/plating/polovich/greenstone,/area/maintenance/polovich/village)
"aH" = (/obj/structure/closet/secure_closet/freezer/fridge,/obj/item/reagent_containers/pill/crocin,/obj/item/reagent_containers/pill/crocin,/obj/item/reagent_containers/pill/crocin,/obj/item/reagent_containers/pill/crocin,/turf/open/floor/plating/polovich/greenstone,/area/maintenance/polovich/village)
"aI" = (/obj/structure/closet/secure_closet/freezer/fridge,/obj/item/reagent_containers/pill/camphor,/obj/item/reagent_containers/pill/camphor,/obj/item/reagent_containers/pill/camphor,/obj/item/reagent_containers/pill/camphor,/obj/item/reagent_containers/pill/hexacrocin,/obj/item/reagent_containers/pill/hexacrocin,/turf/open/floor/plating/polovich/greenstone,/area/maintenance/polovich/village)
"aJ" = (/turf/open/floor/plating/polovich/lightblue,/area/maintenance/polovich/forest)
"aK" = (/turf/open/floor/plating/polovich/roots,/area/maintenance/polovich/forest)
"aL" = (/turf/open/floor/plating/polovich/greengryaz{randomgenerate = 0},/area/maintenance/polovich/forest)
"aM" = (/turf/open/floor/plating/polovich/greendirtevil,/area/maintenance/polovich/forest)
"aN" = (/obj/structure/barricade/flora/crystal/blue,/turf/open/floor/plating/polovich/greengryaz{randomgenerate = 0},/area/maintenance/polovich/forest)
"aO" = (/turf/closed/wall/nocling,/area/maintenance/polovich/forest)
"aP" = (/obj/structure/fluff/statuestone,/turf/open/floor/plating/polovich/greengryaz{randomgenerate = 0},/area/maintenance/polovich/forest)
"aQ" = (/obj/structure/flora/tree/evil,/turf/open/floor/plating/polovich/roots,/area/maintenance/polovich/forest)
"aR" = (/obj/machinery/shower{pixel_y = 16},/obj/structure/window/spawner/east,/obj/structure/window/spawner/west,/turf/open/floor/plating/polovich/metalfloor,/area/maintenance/polovich/forest)
"aS" = (/obj/machinery/shower{pixel_y = 16},/obj/structure/window/spawner/east,/obj/effect/decal/cleanable/vomit/old,/obj/structure/window/spawner/west,/turf/open/floor/plating/polovich/metalfloor,/area/maintenance/polovich/forest)
"aT" = (/obj/machinery/shower{pixel_y = 16},/obj/structure/window/spawner/east,/obj/structure/window/spawner/west,/obj/item/halyabegg,/turf/open/floor/plating/polovich/metalfloor,/area/maintenance/polovich/forest)
"aU" = (/obj/machinery/shower{pixel_y = 16},/obj/structure/window/spawner/east,/obj/structure/window/spawner/west,/obj/effect/decal/cleanable/blood/cum,/turf/open/floor/plating/polovich/metalfloor,/area/maintenance/polovich/forest)
"aV" = (/obj/structure/barricade/flora/crystal/blue,/turf/open/floor/plating/polovich/lightblue,/area/maintenance/polovich/forest)
"aW" = (/obj/machinery/light/small/red/directional/west,/turf/open/floor/plating/polovich/rotten_stones/sec/sev,/area/maintenance/polovich/forest)
"aX" = (/turf/open/floor/plating/polovich/rotten_stones/sec/sev,/area/maintenance/polovich/forest)
"aY" = (/obj/machinery/light/small/red/directional/east,/turf/open/floor/plating/polovich/rotten_stones/sec/sev,/area/maintenance/polovich/forest)
"aZ" = (/obj/machinery/door/keycard/denominator/podozl/chaot,/turf/open/floor/plating/polovich/krutoplitka/krutoplitka2{dir = 1},/area/maintenance/polovich/forest)
"ba" = (/obj/structure/closet/chaotic,/turf/open/floor/plating/polovich/krutoplitka/krutoplitka2{dir = 1},/area/maintenance/polovich/forest)
"bb" = (/obj/structure/closet/chaotic,/obj/item/ammo_box/magazine/ammo_stack/shotgun/buckshot/loaded,/obj/item/ammo_box/magazine/ammo_stack/shotgun/buckshot/loaded,/obj/item/ammo_box/magazine/ammo_stack/shotgun/buckshot/loaded,/turf/open/floor/plating/polovich/krutoplitka/krutoplitka2{dir = 1},/area/maintenance/polovich/forest)
"bc" = (/obj/structure/closet/chaotic,/obj/item/shit,/turf/open/floor/plating/polovich/krutoplitka/krutoplitka2{dir = 8},/area/maintenance/polovich/forest)
"bd" = (/obj/machinery/light/dim/directional/north,/turf/open/floor/plating/polovich/krutoplitka/krutoplitka2{dir = 8},/area/maintenance/polovich/forest)
"be" = (/turf/open/floor/plating/polovich/krutoplitka/krutoplitka2{dir = 8},/area/maintenance/polovich/forest)
"bf" = (/obj/structure/table/reinforced,/obj/item/stack/medical/gauze/improvised,/turf/open/floor/plating/polovich/krutoplitka/krutoplitka2{dir = 8},/area/maintenance/polovich/forest)
"bg" = (/obj/structure/table/reinforced,/obj/item/melee/hehe/pickaxe/iron,/obj/item/melee/hehe/pickaxe/iron,/turf/open/floor/plating/polovich/krutoplitka/krutoplitka2{dir = 8},/area/maintenance/polovich/forest)
"bh" = (/obj/structure/table/reinforced,/obj/item/melee/hehe/pickaxe/iron,/obj/item/melee/hehe/pickaxe/iron,/turf/open/floor/plating/polovich/krutoplitka/krutoplitka2{dir = 1},/area/maintenance/polovich/forest)
"bi" = (/obj/structure/table/reinforced,/obj/item/melee/hehe/pickaxe/iron,/turf/open/floor/plating/polovich/krutoplitka/krutoplitka2{dir = 1},/area/maintenance/polovich/forest)
"bj" = (/turf/open/floor/plating/polovich/rotten_stones/sec/eight,/area/maintenance/polovich/forest)
"bk" = (/turf/open/floor/plating/polovich/krutoplitka/krutoplitka2{dir = 1},/area/maintenance/polovich/forest)
"bl" = (/turf/open/floor/plating/polovich/krutoplitka/krutoplitka2,/area/maintenance/polovich/forest)
"bm" = (/obj/machinery/door/metal_door/south{id_tag = "chaotic"; key_worthy = 1},/turf/open/floor/plating/polovich/krutoplitka/krutoplitka2{dir = 1},/area/maintenance/polovich/forest)
"bn" = (/turf/open/floor/low_wall/window,/area/maintenance/polovich/forest)
"bo" = (/obj/structure/chair/wood,/obj/effect/landmark/start/chaot,/turf/open/floor/plating/polovich/krutoplitka/krutoplitka2,/area/maintenance/polovich/forest)
"bp" = (/obj/structure/chair/wood,/obj/effect/landmark/start/chaot,/turf/open/floor/carpet/purplee,/area/maintenance/polovich/forest)
"bq" = (/turf/open/floor/carpet/purplee,/area/maintenance/polovich/forest)
"br" = (/obj/machinery/light/dim/directional/east,/turf/open/floor/plating/polovich/krutoplitka/krutoplitka2{dir = 1},/area/maintenance/polovich/forest)
"bs" = (/obj/structure/table/reinforced,/obj/item/key/podpol/woody{id_tag = "chaotic"},/turf/open/floor/plating/polovich/krutoplitka/krutoplitka2,/area/maintenance/polovich/forest)
"bt" = (/obj/structure/table/reinforced,/obj/item/reagent_containers/food/drinks/bottle/beer,/turf/open/floor/carpet/purplee,/area/maintenance/polovich/forest)
"bu" = (/obj/machinery/door/metal_door/west{key_worthy = 1; locked = 0},/turf/open/floor/plating/polovich/krutoplitka/krutoplitka2{dir = 1},/area/maintenance/polovich/forest)
"bv" = (/obj/structure/table/reinforced,/obj/item/reagent_containers/food/drinks/bottle/beer,/turf/open/floor/plating/polovich/krutoplitka/krutoplitka2,/area/maintenance/polovich/forest)
"bw" = (/obj/structure/table/reinforced,/obj/item/grenade/gas/incredible_gas,/turf/open/floor/plating/polovich/krutoplitka/krutoplitka2{dir = 1},/area/maintenance/polovich/forest)
"bx" = (/obj/structure/chair/wood{dir = 1},/obj/effect/landmark/start/chaot,/turf/open/floor/plating/polovich/krutoplitka/krutoplitka2{dir = 1},/area/maintenance/polovich/forest)
"by" = (/obj/structure/weightmachine/stacklifter,/turf/open/floor/plating/polovich/rotten_stones/sec/eight,/area/maintenance/polovich/forest)
"bz" = (/obj/structure/table/reinforced,/obj/item/stack/medical/gauze/improvised/one,/turf/open/floor/plating/polovich/krutoplitka/krutoplitka2{dir = 4},/area/maintenance/polovich/forest)
"bA" = (/obj/structure/table/reinforced,/obj/item/gun/ballistic/shotgun/automatic/b2000,/turf/open/floor/plating/polovich/krutoplitka/krutoplitka2{dir = 4},/area/maintenance/polovich/forest)
"bB" = (/obj/structure/chair/wood{dir = 8},/mob/living/simple_animal/pet/podozl/shoebill,/turf/open/floor/plating/polovich/krutoplitka/krutoplitka2{dir = 4},/area/maintenance/polovich/forest)
"bC" = (/obj/machinery/light/dim/directional/south,/turf/open/floor/plating/polovich/krutoplitka/krutoplitka2{dir = 1},/area/maintenance/polovich/forest)
"bD" = (/obj/machinery/light/small/red/directional/south,/turf/open/floor/plating/polovich/krutoplitka/krutoplitka2,/area/maintenance/polovich/forest)
"bE" = (/turf/open/floor/plating/polovich/krutoplitka/krutoplitka2{dir = 4},/area/maintenance/polovich/forest)
"bF" = (/obj/machinery/light/small/red/directional/south,/turf/open/floor/plating/polovich/krutoplitka/krutoplitka2{dir = 4},/area/maintenance/polovich/forest)
"bG" = (/obj/structure/gptdfm/entrance,/turf/open/floor/plating/polovich/rotten_stones/sec/sev,/area/maintenance/polovich/forest)
"bH" = (/obj/structure/flora/ausbushes/bushka,/turf/open/floor/plating/polovich/asteroid/snow/river/nevado_surface/shallow/ankle,/area/maintenance/polovich/forest)
"bI" = (/turf/open/floor/plating/polovich/asteroid/snow/river/nevado_surface/shallow/ankle,/area/maintenance/polovich/forest)
"bJ" = (/obj/item/grenade/frag,/turf/open/floor/plating/polovich/greengryaz{randomgenerate = 0},/area/maintenance/polovich/forest)
"bK" = (/turf/open/floor/plating/polovich/slush/mudd,/area/maintenance/polovich/forest)
"bL" = (/obj/structure/barricade/flora/crystal/blue,/turf/open/floor/plating/polovich/slush/mudd,/area/maintenance/polovich/forest)
"bM" = (/obj/structure/beast/tohubohu,/turf/open/floor/plating/polovich/lightblue,/area/maintenance/polovich/forest)
"bN" = (/obj/structure/flora/ausbushes/zarosli/midnight,/turf/open/floor/plating/polovich/greengryaz,/area/maintenance/polovich/forest)
"bO" = (/obj/structure/flora/ausbushes/zarosli/midnight,/turf/open/floor/plating/polovich/asteroid/snow/river/nevado_surface/shallow/ankle,/area/maintenance/polovich/forest)
"bP" = (/obj/structure/lampstand,/turf/open/floor/plating/polovich/lightblue,/area/maintenance/polovich/forest)
"bQ" = (/obj/structure/lampstand,/turf/open/floor/plating/polovich/slush/mudd,/area/maintenance/polovich/forest)
"bR" = (/obj/structure/sign/poster/official/dick_gum,/turf/closed/wall/purple/nocling,/area/maintenance/polovich/forest)
"bS" = (/obj/structure/flora/tree/evil/long,/turf/open/floor/plating/polovich/roots,/area/maintenance/polovich/forest)
"bT" = (/obj/effect/landmark/tendance/willet,/turf/open/floor/plating/polovich/asteroid/snow/river/nevado_surface/shallow/ankle,/area/maintenance/polovich/forest)
"bU" = (/turf/open/floor/plating/polovich/greengryaz/norandomgen,/area/maintenance/polovich/forest)
"bV" = (/obj/structure/lampstand,/turf/open/floor/plating/polovich/greengryaz{randomgenerate = 0},/area/maintenance/polovich/forest)
"bW" = (/obj/structure/closet/crate,/obj/item/gun/ballistic/rifle/boltaction/remis/federson,/turf/open/floor/plating/polovich/greengryaz/norandomgen,/area/maintenance/polovich/forest)
"bX" = (/turf/closed/wall/purple/nocling/hard_to_break,/area/maintenance/polovich/catacombs)
"bY" = (/turf/open/floor/plating/polovich/greengryaz,/area/maintenance/polovich/catacombs)
"bZ" = (/turf/closed/indestructible/start_area,/area/start)
"ca" = (/obj/effect/landmark/start/new_player,/turf/open/floor/plating,/area/start)
"cb" = (/turf/closed/indestructible/splashscreen,/area/start)
"cc" = (/turf/closed/wall/darkrock/nocling,/area/maintenance/polovich/village)
"cd" = (/obj/structure/halo/whiteblack,/obj/effect/spawner/liquid/shallow/flood,/turf/open/floor/plating/polovich/kruto,/area/maintenance/polovich/village)
"ce" = (/obj/structure/halo/whiteblack,/obj/docking_port/stationary{dir = 1; dwidth = 25; height = 50; id = "emergency_away"; json_key = "emergency"; name = "CentCom Emergency Shuttle Dock"; width = 50},/obj/effect/spawner/liquid/shallow/flood,/turf/open/floor/plating/polovich/kruto,/area/maintenance/polovich/village)
"cf" = (/obj/structure/closet/secure_closet/freezer/fridge,/obj/item/stack/medical/mesh,/obj/item/storage/belt/pouch/venturer/noble,/turf/open/floor/plating/polovich/greenstone,/area/maintenance/polovich/village)

(1,1,1) = {"
bXbXbXbXbXbXbXbXbXbXbXbXbXbXbXbXbXbXbXbXbXababababababababababababababababababababababababababababababababababababababababababababababababababababababababababab
bXbYbYbZbZbZbZbZbZbZbZbZbZbZbZbZbZbZbZbZbXababababababababababababababababababababababababababababababababababababababababababababababababababababababababababab
bXbYbYbZbZbZbZbZbZbZbZbZbZbZbZbZbZbZbZbZbXababababababababababababababababababababababababababababababababababababababababababababababababababababababababababab
bXbYbYbZbZbZbZbZbZbZbZbZbZbZbZbZbZbZbZbZbXababababababababababababababababababababababababababababababababababababababababababababababababababababababababababab
bXbYbYbZbZbZbZbZbZbZbZbZbZbZbZbZbZbZbZbZbXababababababababababababababababababababababababababababababababababababababababababababababababababababababababababab
bXbYbYbZbZbZbZbZbZbZbZbZbZbZbZbZbZbZbZbZbXababababababababababababababababababababababababababababababababababababababababababababababababababababababababababab
bXbYbYbZbZbZbZbZbZbZbZbZbZbZbZbZbZbZbZbZbXababababababababababababababababababababababababababababababababababababababababababababababababababababababababababab
bXbYbYbZbZbZbZbZbZbZbZbZbZbZbZbZbZbZbZbZbXababababababababababababababababababababababababababababababababababababababababababababababababababababababababababab
bXbYbYbZbZbZbZbZbZbZcabZbZbZbZbZbZbZbZbZbXababababababababababababababababababababababababababababababababababababababababababababababababababababababababababab
bXbYbYbZbZbZbZbZbZbZbZbZbZbZbZbZbZbZbZbZbXabababababccccccccccccccccccccccccccccccccccccccccccccccccccccccccccccccccccabababababababavavavavavavavavavavavavavav
bXbYbYbZbZbZbZbZbZbZbZbZbZbZbZbZbZbZbZbZbXabababababcccdcdcdcdcdcdcdcdcdcdcdcdcdcdcdcdcdcdcdcdcdcdcdcdcdcdcdcdcdcdcdccabababababababavavavavavavawaxawavavavavav
bXbYbYbZbZbZbZbZbZbZbZbZbZbZbZbZbZbZbZbZbXabababababcccdcdcdcdcdcdcdcdcdcdcdcdcdcdcdcdcdcdcdcdcdcdcdcdcdcdcdcdcdcdcdccabababababababavavayayazavaAaAavazaBaCavav
bXbYbYbZbZbZbZbZbZbZbZbZbZbZbZbZbZbZbZbZbXabababababcccdcdcdcdcdcdcdcdcdcdcdcdcdcdcdcdcdcdcdcdcdcdcdcdcdcdcdcdcdcdcdccabababababababavaBaAaAawavaAaAavawaAaAaDav
bXbYbYbZbZbZbZbZbZbZbZbZbZbZbZbZbZbZbZbZbXabababababcccdcdcdcdcdcdcdcdcdcdcdcdcdcdcdcdcdcdcdcdcdcdcdcdcdcdcdcdcdcdcdccabababababababavaEaAaAaAaAaAaAaAaAaAaAcfav
bXbYbYbZbZbZbZbZbZbZbZbZbZbZbZbZbZbZbZbZbXabababababcccdcdcdcdcdcdcdcdcdcdcdcdcdcdcdcdcdcdcdcdcdcdcdcdcdcdcdcdcdcdcdccabababababababavazawaAawavaAaAavawaAawazav
bXbYbYcbbZbZbZbZbZbZbZbZbZbZbZbZbZbZbZbZbXabababababcccdcdcdcdcdcdcdcdcdcdcdcdcdcdcdcdcdcdcdcdcdcdcdcdcdcdcdcdcdcdcdccabababababababavavavavavavaAaAavavavavavav
bXbXbXbXbXbXbXbXbXbXbXbXbXbXbXbXbXbXbXbXbXabababababcccdcdcdcdcdcdcdcdcdcdcdcdcdcdcdcdcdcdcdcdcdcdcdcdcdcdcdcdcdcdcdccabababababababavazaAaFaGawaAaAawaHaIaAazav
ababababababababababababababababababababababababababcccdcdcdcdcdcdcdcdcdcdcdcdcdcdcdcdcdcdcdcdcdcdcdcdcdcdcdcdcdcdcdccabababababababavawaAaAaAaAaAaAaAaAaAaAawav
ababababababababababababababababababababababababababcccdcdcdcdcdcdcdcdcdcdcdcdcdcdcdcdcdcdcdcdcdcdcdcdcdcdcdcdcdcdcdccabababababababavavavaAaAaAaAaAaAaAaAavavav
ababababababababababababababababababababababababababcccdcdcdcdcdcdcdcdcdcdcdcdcdcdcdcdcdcdcdcdcdcdcdcdcdcdcdcdcdcdcdccabababababababavavavawazawaAaAawazawavavav
ababababababababababababababababababababababababababcccdcdcdcdcdcdcdcdcdcdcdcdcdcdcdcdcdcdcdcdcdcdcdcdcdcdcdcdcdcdcdccabababababababavavavavavavavavavavavavavav
ababababababababababababababababababababababababababcccdcdcdcdcdcdcdcdcdcdcdcdcdcdcdcdcdcdcdcdcdcdcdcdcdcdcdcdcdcdcdccababababababababababababababababababababab
ababababababababababababababababababababababababababcccdcdcdcdcdcdcdcdcdcdcdcdcdcdcdcdcdcdcdcdcdcdcdcdcdcdcdcdcdcdcdccababababababababababababababababababababab
ababababababababababababababababababababababababababcccdcdcdcdcdcdcdcdcdcdcdcdcdcdcdcdcdcdcdcdcdcdcdcdcdcdcdcdcdcdcdccababababababababababababababababababababab
ababababababababababababababababababababababababababcccdcdcdcdcdcdcdcdcdcdcdcdcdcdcdcdcdcdcdcdcdcdcdcdcdcdcdcdcdcdcdccababababababababababababababababababababab
ababababababababababababababababababababababababababcccdcdcdcdcdcdcdcdcdcdcdcdcdcdcdcdcdcdcdcdcdcdcdcdcdcdcdcdcdcdcdccababababababababababababababababababababab
ababababababababababababababababababababababababababcccdcdcdcdcdcdcdcdcdcdcdcdcdcdcecdcdcdcdcdcdcdcdcdcdcdcdcdcdcdcdccababababababababababababababababababababab
ababababababababababababababababababababababababababcccdcdcdcdcdcdcdcdcdcdcdcdcdcdcdcdcdcdcdcdcdcdcdcdcdcdcdcdcdcdcdccababababababababababababababababababababab
ababababababababababababababababababababababababababcccdcdcdcdcdcdcdcdcdcdcdcdcdcdcdcdcdcdcdcdcdcdcdcdcdcdcdcdcdcdcdccababababababababababababababababababababab
ababababababababababababababababababababababababababcccdcdcdcdcdcdcdcdcdcdcdcdcdcdcdcdcdcdcdcdcdcdcdcdcdcdcdcdcdcdcdccababababababababababababababababababababab
ababababababababababababababababababababababababababcccdcdcdcdcdcdcdcdcdcdcdcdcdcdcdcdcdcdcdcdcdcdcdcdcdcdcdcdcdcdcdccababababababababababababababababababababab
ababababababababababababababababababababababababababcccdcdcdcdcdcdcdcdcdcdcdcdcdcdcdcdcdcdcdcdcdcdcdcdcdcdcdcdcdcdcdccababababababababababababababababababababab
ababababababababababababababababababababababababababcccdcdcdcdcdcdcdcdcdcdcdcdcdcdcdcdcdcdcdcdcdcdcdcdcdcdcdcdcdcdcdccababababababababababababababababababababab
ababababababababababababababababababababababababababcccdcdcdcdcdcdcdcdcdcdcdcdcdcdcdcdcdcdcdcdcdcdcdcdcdcdcdcdcdcdcdccababababababababababababababababababababab
ababababababababababababababababababababababababababcccdcdcdcdcdcdcdcdcdcdcdcdcdcdcdcdcdcdcdcdcdcdcdcdcdcdcdcdcdcdcdccababababababababababababababababababababab
ababababababababababababababababababababababababababcccdcdcdcdcdcdcdcdcdcdcdcdcdcdcdcdcdcdcdcdcdcdcdcdcdcdcdcdcdcdcdccababababababababababababababababababababab
ababababababababababababababababababababababababababcccdcdcdcdcdcdcdcdcdcdcdcdcdcdcdcdcdcdcdcdcdcdcdcdcdcdcdcdcdcdcdccababababababababababababababababababababab
ababababababababababababababababababababababababababcccdcdcdcdcdcdcdcdcdcdcdcdcdcdcdcdcdcdcdcdcdcdcdcdcdcdcdcdcdcdcdccababababababababababababababababababababab
ababababababababababababababababababababababababababcccdcdcdcdcdcdcdcdcdcdcdcdcdcdcdcdcdcdcdcdcdcdcdcdcdcdcdcdcdcdcdccababababababababababababababababababababab
ababababababababababababababababababababababababababcccdcdcdcdcdcdcdcdcdcdcdcdcdcdcdcdcdcdcdcdcdcdcdcdcdcdcdcdcdcdcdccababababababababababababababababababababab
ababababababababababababababababababababababababababcccdcdcdcdcdcdcdcdcdcdcdcdcdcdcdcdcdcdcdcdcdcdcdcdcdcdcdcdcdcdcdccababababababababababababababababababababab
ababababababababababababababababababababababababababcccdcdcdcdcdcdcdcdcdcdcdcdcdcdcdcdcdcdcdcdcdcdcdcdcdcdcdcdcdcdcdccababababababababababababababababababababab
ababababababababababababababababababababababababababcccdcdcdcdcdcdcdcdcdcdcdcdcdcdcdcdcdcdcdcdcdcdcdcdcdcdcdcdcdcdcdccababababababababababababababababababababab
ababababababababababababababababababababababababababcccdcdcdcdcdcdcdcdcdcdcdcdcdcdcdcdcdcdcdcdcdcdcdcdcdcdcdcdcdcdcdccababababababababababababababababababababab
ababababababababababababababababababababababababababcccdcdcdcdcdcdcdcdcdcdcdcdcdcdcdcdcdcdcdcdcdcdcdcdcdcdcdcdcdcdcdccababababababababababababababababababababab
ababababababababababababababababababababababababababcccdcdcdcdcdcdcdcdcdcdcdcdcdcdcdcdcdcdcdcdcdcdcdcdcdcdcdcdcdcdcdccababababababababababababababababababababab
ababababababababababababababababababababababababababcccdcdcdcdcdcdcdcdcdcdcdcdcdcdcdcdcdcdcdcdcdcdcdcdcdcdcdcdcdcdcdccababababababababababababababababababababab
ababababababababababababababababababababababababababcccdcdcdcdcdcdcdcdcdcdcdcdcdcdcdcdcdcdcdcdcdcdcdcdcdcdcdcdcdcdcdccababababababababababababababababababababab
ababababababababababababababababababababababababababcccdcdcdcdcdcdcdcdcdcdcdcdcdcdcdcdcdcdcdcdcdcdcdcdcdcdcdcdcdcdcdccababababababababababababababababababababab
ababababababababababababababababababababababababababcccdcdcdcdcdcdcdcdcdcdcdcdcdcdcdcdcdcdcdcdcdcdcdcdcdcdcdcdcdcdcdccababababababababababababababababababababab
ababababababababababababababababababababababababababcccdcdcdcdcdcdcdcdcdcdcdcdcdcdcdcdcdcdcdcdcdcdcdcdcdcdcdcdcdcdcdccababababababababababababababababababababab
ababababababababababababababababababababababababababcccdcdcdcdcdcdcdcdcdcdcdcdcdcdcdcdcdcdcdcdcdcdcdcdcdcdcdcdcdcdcdccababababababababababababababababababababab
ababababababababababababababababababababababababababccccccccccccccccccccccccccccccccccccccccccccccccccccccccccccccccccababababababababababababababababababababab
abababababababababababababababababababababababababababababababababababababababababababababababababababababababababababababababababababababababababababababababab
abababababababababababababababababababababababababababababababababababababababababababababababababababababababababababababababababababababababababababababababab
abababababababababababababababababababababababababababababababababababababababababababababababababababababababababababababababababababababababababababababababab
abababababababababababababababababababababababababababababababababababababababababababababababababababababababababababababababababababababababababababababababab
abababababababababababababababababababababababababababababababababababababababababababababababababababababababababababababababababababababababababababababababab
ababababababababababababababababababababababababababababababababababababababababababababababababababababaLbJaLaLabbKbKbKbLbMaVbNbObIbIababababababababababababab
abababababababababababababababababababababababababababababababababababababababababababababababababababababaQaJaLabbKbKbKbKbKaJbIbIbIaLababababababababababababab
abababababababababababababababababababababababababababababababababababababababababababababababababababaJbPaLaJaLbQbKaJaLbIbIbIbIbRaLbSaKaKaMaMababababababababab
abababababababababababababababababababababababababababababababababababababababababababababababababababaMaMaMaJaMaMaJaJaLbIbTbIbIbIbIbHabaKbUbUababababababababab
abababababababababababababababababababababababababababababababababababababababababababababababababababaJaMaMbGaMaJaLaLaLbIbIbIaJaMaMaLabababbUaJabababababababab
abababababababababababababababababababababababababababababababababababababababababababababababababababaJaMaMaMaMaMaLaMaNaJaLaLaVaLaMaJababaMaJaJabababababababab
ababababababababababababababababababababababababababababababababababababababababababababababababababababbVaLaLaJbPaQaMaPaJaMaMaPaJaJaJababbWbUaJaJababababababab
abababababababababababababababababababababababababababababababababababababababababababababababababababababaLaLaLaLaKaLaNaLaMaMaNaLaKaLaOaOaOaOaOaOababababababab
abababacacadadadadadadadadadadadadacacacacacacacacacacacacabababababababababababababababababababababababababababaJaJaMaPaLaJaJaPaKaQaMaOaRaSaTaUaOababababababab
abababaeaeadafagahagagaiaiagajakadacacacacacacacacacacacacabababababababababababababababababababababababababababaJaJaMaJaMaLaVaNaLaMaMaOaWaXaXaYaOababababababab
abababaealamagagagagagagagagagagadacacacacacacacacacacacacababababababababababababababababababababababababababaOaOaOaOaOaZaZaOaOaOaOaOaOaXaXaXaXaOababababababab
abababaeaeadanagagagagagagagaganadadadadadadadadadadadadadababababababababababababababababababababababababababaObabbbcbdbebebdbfbgbhbiaObjaXaXbjaOababababababab
abababacacadaoagagagagagagagagaoadagagagagapagaqagapagagadababababababababababababababababababababababababababaObkbkbebeblbebeblblblbkaOaObmbmbnaOababababababab
abababacacadanafafanagaganafafanadasagarasagagagagagasagadababababababababababababababababababababababababababaObkbobpbqblbqbqblbqbqbraObkbkbkbkaOababababababab
ababababacadadadadadagagadadadadadagagagagapagapagapagagadababababababababababababababababababababababababababaObkbsbtbqblbqbqblbqbqbkbubkbkbkbkaOababababababab
ababababacadagagagagagagagagagagagagagagasagagagagagasagagaaabababababababababababababababababababababababababaObkbvbwbkbkbkbkblbkblbkbublblblblaOababababababab
ababababacadanagaganagaganatauanagagagagagapagapagapagagagaaabababababababababababababababababababababababababaObkbxbxbkblblblbybkbybrbnblbzbAbBaOababababababab
ababababacadagagagagagagagagagagagagagagagapagapagapagagagaaabababababababababababababababababababababababababaObkbkbkbCbkbkbCbkbkbkbkaObDbEbEbFaOababababababab
ababababacadagagagagagagagagagagagagagagasagagagagagasagadababababababababababababababababababababababababababaOaOaOaOaOaOaOaOaOaOaOaOaOaOaOaOaOaOababababababab
ababababacadanagaganagaganagaganagagagagagapagaqagapagagadababababababababababababababababababababababababababababababababababababababababababababababababababab
ababababacadagagagagagagagagagagagagagagasagagagagagasagadababababababababababababababababababababababababababababababababababababababababababababababababababab
ababababacadadadadadadadadadadadadadadadadadadadadadadadadababababababababababababababababababababababababababababababababababababababababababababababababababab
"}
