"aa" = (/turf/open/openspace/norm,/area/maintenance/polovich/forest)
"ab" = (/turf/closed/wall/purple/nocling/hard_to_break,/area/maintenance/polovich/forest)
"ac" = (/obj/machinery/door/metal_door/wood_door/north{id_tag = "carehouse"},/turf/open/floor/plating/polovich/greenishe2,/area/maintenance/polovich/forest)
"ad" = (/turf/open/floor/plating/polovich/lightblue,/area/maintenance/polovich/forest)
"ae" = (/obj/effect/mapping_helpers/sunlight/pseudo_roof_setter/mountain,/turf/closed/wall/purple/nocling,/area/maintenance/polovich/forest)
"af" = (/obj/effect/mapping_helpers/sunlight/pseudo_roof_setter/mountain,/turf/open/floor/plating/polovich/greenishe2,/area/maintenance/polovich/forest)
"ag" = (/turf/open/floor/plating/polovich/greenishe2,/area/maintenance/polovich/forest)
"ah" = (/obj/effect/mapping_helpers/sunlight/pseudo_roof_setter/mountain,/turf/closed/wall/mineral/wood/nocling,/area/maintenance/polovich/forest)
"ai" = (/turf/closed/wall/darkrock/nocling,/area/maintenance/polovich/village)
"aj" = (/obj/effect/mapping_helpers/sunlight/pseudo_roof_setter/mountain,/turf/open/floor/low_wall/window,/area/maintenance/polovich/forest)
"ak" = (/turf/open/floor/plating/polovich/kollo,/area/maintenance/polovich/village)
"al" = (/obj/docking_port/stationary{dir = 1; dwidth = 11; height = 18; id = "emergency_home"; name = "DeltaStation emergency evac bay"; width = 30},/turf/open/floor/plating/polovich/kollo,/area/maintenance/polovich/village)
"am" = (/obj/structure/bed,/obj/effect/landmark/start/venturer,/obj/effect/mapping_helpers/sunlight/pseudo_roof_setter/mountain,/turf/open/floor/plating/polovich/greenishe2,/area/maintenance/polovich/forest)
"an" = (/obj/structure/lampstand,/turf/open/floor/plating/polovich/kollo,/area/maintenance/polovich/village)
"ao" = (/turf/open/floor/plating/polovich/rockedarrr,/area/maintenance/polovich/village)
"ap" = (/obj/effect/mapping_helpers/sunlight/pseudo_roof_setter/mountain,/obj/structure/closet/crate/wooden,/obj/item/cellphone,/obj/item/cellphone,/obj/item/cellphone,/obj/item/simcard,/obj/item/simcard,/obj/item/simcard,/turf/open/floor/plating/polovich/logsgreen/two,/area/maintenance/polovich/forest)
"aq" = (/turf/open/floor/plating/polovich/rockyhorrr,/area/maintenance/polovich/village)
"ar" = (/turf/open/openspace/norm,/area/maintenance/polovich/village)
"as" = (/turf/open/floor/plating/polovich/woodennewblue,/area/maintenance/polovich/village)
"at" = (/obj/structure/closet/crate/wooden,/obj/effect/mapping_helpers/sunlight/pseudo_roof_setter/mountain,/obj/item/clothing/head/bighatnice,/turf/open/floor/plating/polovich/greenishe2,/area/maintenance/polovich/forest)
"au" = (/turf/open/floor/plating/polovich/logsgreen{dir = 1},/area/maintenance/polovich/village)
"av" = (/obj/structure/closet/crate/wooden,/obj/effect/mapping_helpers/sunlight/pseudo_roof_setter/mountain,/obj/item/food/grown/aguo,/obj/structure/lampwall/service/directional/north,/turf/open/floor/plating/polovich/greenishe2,/area/maintenance/polovich/forest)
"aw" = (/obj/effect/mapping_helpers/sunlight/pseudo_roof_setter/mountain,/obj/structure/lampwall/service/directional{dir = 1},/turf/open/floor/plating/polovich/greenishe2,/area/maintenance/polovich/forest)
"ax" = (/turf/open/floor/plating/polovich/greenishe,/area/maintenance/polovich/forest)
"ay" = (/turf/open/floor/plating/polovich/logsgreen/two{dir = 8},/area/maintenance/polovich/village)
"az" = (/turf/open/floor/plating/polovich/logsgreen{dir = 4},/area/maintenance/polovich/village)
"aA" = (/obj/structure/ladder,/turf/open/floor/plating/polovich/logsgreen/two{dir = 8},/area/maintenance/polovich/village)
"aB" = (/turf/open/floor/plating/polovich/woodennewblue,/area/maintenance/polovich/forest)
"aC" = (/obj/effect/mapping_helpers/sunlight/pseudo_roof_setter/wood,/turf/closed/wall/mineral/wood,/area/maintenance/polovich/village)
"aD" = (/obj/effect/mapping_helpers/sunlight/pseudo_roof_setter/wood,/turf/open/floor/plating/polovich/logsgreen,/area/maintenance/polovich/village)
"aE" = (/obj/structure/lampwall/service/directional/north,/obj/effect/mapping_helpers/sunlight/pseudo_roof_setter/wood,/turf/open/floor/plating/polovich/logsgreen,/area/maintenance/polovich/village)
"aF" = (/obj/effect/mapping_helpers/sunlight/pseudo_roof_setter/wood,/turf/open/floor/low_wall/window,/area/maintenance/polovich/village)
"aG" = (/obj/effect/mapping_helpers/sunlight/pseudo_roof_setter/wood,/turf/open/floor/plating/polovich/logsgreen/two,/area/maintenance/polovich/village)
"aH" = (/obj/effect/mapping_helpers/sunlight/pseudo_roof_setter/wood,/turf/closed/wall/mineral/wood/nocling,/area/maintenance/polovich/village)
"aI" = (/obj/structure/railing,/obj/effect/mapping_helpers/sunlight/pseudo_roof_setter/wood,/turf/open/floor/plating/polovich/logsgreen{dir = 8},/area/maintenance/polovich/village)
"aJ" = (/obj/structure/chair/wood,/obj/effect/landmark/start/aktliver,/obj/effect/mapping_helpers/sunlight/pseudo_roof_setter/wood,/turf/open/floor/plating/polovich/logsgreen/two,/area/maintenance/polovich/village)
"aK" = (/obj/structure/railing{dir = 4},/obj/effect/mapping_helpers/sunlight/pseudo_roof_setter/wood,/turf/open/floor/plating/polovich/logsgreen/two,/area/maintenance/polovich/village)
"aL" = (/obj/effect/mapping_helpers/sunlight/pseudo_roof_setter/wood,/turf/open/openspace/norm,/area/maintenance/polovich/village)
"aM" = (/obj/structure/table/reinforced,/obj/effect/mapping_helpers/sunlight/pseudo_roof_setter/wood,/turf/open/floor/plating/polovich/logsgreen/two,/area/maintenance/polovich/village)
"aN" = (/obj/structure/chair/wood{dir = 8},/obj/effect/landmark/start/aktliver,/obj/effect/mapping_helpers/sunlight/pseudo_roof_setter/wood,/turf/open/floor/plating/polovich/logsgreen/two,/area/maintenance/polovich/village)
"aO" = (/obj/effect/mapping_helpers/sunlight/pseudo_roof_setter/wood,/turf/open/floor/plating/polovich/logsgreen{dir = 8},/area/maintenance/polovich/village)
"aP" = (/obj/effect/mapping_helpers/sunlight/pseudo_roof_setter/wood,/obj/structure/lampwall/service{dir = 1},/turf/open/floor/plating/polovich/logsgreen{dir = 8},/area/maintenance/polovich/village)
"aQ" = (/obj/structure/chair/wood{dir = 1},/obj/effect/landmark/start/aktliver,/obj/effect/mapping_helpers/sunlight/pseudo_roof_setter/wood,/turf/open/floor/plating/polovich/logsgreen{dir = 8},/area/maintenance/polovich/village)
"aR" = (/obj/structure/lampwall/service{dir = 1},/obj/effect/mapping_helpers/sunlight/pseudo_roof_setter/wood,/turf/open/floor/plating/polovich/logsgreen{dir = 8},/area/maintenance/polovich/village)
"aS" = (/turf/open/floor/plating/polovich/greengryaz,/area/maintenance/polovich/forest)
"aT" = (/turf/open/floor/plating/polovich/greendirtevil,/area/maintenance/polovich/forest)
"aU" = (/obj/structure/lampstand,/turf/open/floor/plating/polovich/greengryaz,/area/maintenance/polovich/forest)
"aV" = (/obj/structure/lampstand,/turf/open/floor/plating/polovich/greendirtevil,/area/maintenance/polovich/forest)
"aW" = (/obj/structure/flora/tree/evil,/turf/open/floor/plating/polovich/roots,/area/maintenance/polovich/forest)
"aX" = (/turf/open/floor/plating/polovich/roots,/area/maintenance/polovich/forest)
"aY" = (/obj/structure/flora/ausbushes/zarosli/midnight,/turf/open/floor/plating/polovich/greendirtevil,/area/maintenance/polovich/forest)
"aZ" = (/obj/structure/flora/ausbushes/zarosli/midnight,/turf/open/floor/plating/polovich/greengryaz,/area/maintenance/polovich/forest)
"ba" = (/turf/open/floor/plating/polovich/asteroid/snow/river/nevado_surface/shallow/ankle,/area/maintenance/polovich/forest)
"bb" = (/obj/structure/flora/ausbushes/bushka,/turf/open/floor/plating/polovich/asteroid/snow/river/nevado_surface/shallow/ankle,/area/maintenance/polovich/forest)
"bc" = (/turf/open/floor/plating/polovich/dirt/dark/gryazka,/area/maintenance/polovich/forest)
"bd" = (/obj/structure/flora/ausbushes/zarosli/midnight,/turf/open/floor/plating/polovich/dirt/dark/gryazka,/area/maintenance/polovich/forest)
"be" = (/obj/structure/flora/ausbushes/zarosli/midnight,/turf/open/floor/plating/polovich/lightblue,/area/maintenance/polovich/forest)
"bf" = (/obj/effect/spawner/random/structure/maphelp/fire/inferno/ten/magic,/turf/open/floor/plating/polovich/dirt/dark/gryazka,/area/maintenance/polovich/forest)
"bg" = (/obj/effect/spawner/random/structure/maphelp/fire/inferno/ten/magic,/turf/open/floor/plating/polovich/greendirtevil,/area/maintenance/polovich/forest)
"bh" = (/obj/structure/gptdfm/exit,/turf/open/floor/plating/polovich/asteroid/snow/river/nevado_surface/shallow/ankle,/area/maintenance/polovich/forest)
"bi" = (/obj/structure/barricade/flora/crystal/green,/turf/open/floor/plating/polovich/lightblue,/area/maintenance/polovich/forest)
"bj" = (/obj/structure/barricade/flora/crystal/green,/turf/open/floor/plating/polovich/greengryaz,/area/maintenance/polovich/forest)
"bk" = (/obj/structure/barricade/flora/crystal/green,/turf/open/floor/plating/polovich/greendirtevil,/area/maintenance/polovich/forest)
"bl" = (/turf/open/floor/plating/polovich/slushy,/area/maintenance/polovich/forest)
"bm" = (/turf/open/floor/plating/polovich/slushyy,/area/maintenance/polovich/forest)

(1,1,1) = {"
aaaaaaaaaaaaaaaaaaaaaaaaaaaaaaaaaaaaaaaaaaaaaaaaaaaaaaaaaaaaaaaaaaaaaaaaaaaaaaaaaaaaaaaaaaaaaaaaaaaaaaaaaaaaaaaaaaaaaaaaaaaaaaaaaaaaaaaaaaaaaaaaaaaaaaaaaaaaaaaa
aaaaaaaaaaaaaaaaaaaaaaaaaaaaaaaaaaaaaaaaaaaaaaaaaaaaaaaaaaaaaaaaaaaaaaaaaaaaaaaaaaaaaaaaaaaaaaaaaaaaaaaaaaaaaaaaaaaaaaaaaaaaaaaaaaaaaaaaaaaaaaaaaaaaaaaaaaaaaaaa
aaaaaaaaaaaaaaaaaaaaaaaaaaaaaaaaaaaaaaaaaaaaaaaaaaaaaaaaaaaaaaaaaaaaaaaaaaaaaaaaaaaaaaaaaaaaaaaaaaaaaaaaaaaaaaaaauayayayayayayayayayayayayayayayayayayayayazaaaa
aaaaaaaaaaaaaaaaaaaaaaaaaaaaaaaaaaaaaaaaaaaaaaaaaaaaaaaaaaaaaaaaaaaaaaaaaaaaaaaaaaaaaaaaaaaaaaaaaaaaaaaaaaaaaaaaauayayayayayayayayayayayayayayayayayayayayazaaaa
aaaaaaaaaaaaaaaaaaaaaaaaaaaaaaaaaaaaaaaaaxagagagagagahaaaaaaaaaaaaaaaaaaaaaaaaaaaaaaaaaaaaaaaaaaaaaaaaaaaaaaaaaaauayayayayayayayayayayayayayayayayayayayayazaaaa
aaaaaaaaaaaaaaaaaaaaaaaaaaaaaaaaaaaaaaaaaxahahahahahahaaaaaaaaaaaaaaaCaCaCaCaCaCaCaCaCaCaCaCaCaCaCaCaCaCaCaaaaaaauayayayayayayayayayayayayayayayayayayayayazaaaa
aaaaaaaaaaaaaaaaaaaaaaaaaaaaaaaaaaaaaaaaaxajafamavamahaaaaaaaaaaaaaaaCaDaDaDaDaDaDaDaDaEaDaDaDaDaDaDaDaDaCaaaaaaauayayayayayayayayayayayayayayayayayayayayazaaaa
aaaaaaaaaaaaaaaaaaaaaaaaaaaaaaaaaaaaaaaaaxahafafafafahaaaaaaaaaaaaaaaFaGaGaGaGaGaHaGaGaGaGaGaHaGaGaGaGaGaFaaaaaaauayayayayayayayayayayayayayayayayayayayayazaaaa
aaaaaaaaaaaaaaaaaaaaaaaaaaaaaaaaaaaaaaaaaxahapafagafahaaaaaaaaaaaaaaaCaGaGaGaGaIaHaJaGaGaGaIaHaGaGaGaGaIaCaaaaaaauayayayayayayayayayayayayayayayayayayaAayazaaaa
aaaaaaaaaaaaaaaaaaaaaaaaaaaaaaaaaaaaaaaaaxajafafafafahaaaaaaaaaaaaaaaCaGaGaGaKaLaHaMaNaGaKaLaHaGaGaGaKaLaCaaaaaaauayayayayayayayayayayayayayayayayayayayayazaaaa
aaaaaaaaaaaaaaaaaaaaaaaaaaaaaaaaaaaaaaaaaxahatafafafahaaaaaaaaaaaaaaaCaOaOaOaOaPaHaQaOaRaOaOaHaOaOaOaOaPaCaaaaaaauayayayayayayayayayayayayayayayayayayayayazaaaa
aaaaaaaaaaaaaaaaaaaaaaaaaaaaaaaaaaaaaaaaadahafawafafahaaaaaaaaaaaaaaaCaCaCaCaCaCaCaFaFaFaFaFaCaFaFaFaFaFaCaaaaaaaaaaaaaaaaaaaaaaaaaaaaaaaaaaaaaaaaaaaaaaaaaaaaaa
aaaaaaaaaaaaaaaaaaaaaaaaaaaaaaaaaaaaaaaaadahahahacahahaaaaaaaaaaaaaaaaaaaaaaaaaaaaaaaaaaaaaaaaaaaaaaaaaaaaaaaaaaaaaaaaaaaaaaaaaaaaaaaaaaaaaaaaaaaaaaaaaaaaaaaaaa
aaaaaaaaaaaaaaaaaaaaaaaaaaaaaaaaaaaaaaaaaaaaafafafafaeaaaaaaaaaaaaaaaaaaaaaaaaaaaaaaaaaaaaaaaaaaaaaaaaaaaaaaaaaaaaaaaaaaaaaaaaaaaaaaaaaaaaaaaaaaaaaaaaaaaaaaaaaa
aaaaaaaaaaaaaaaaaaaaaaaaaaaaaaaaaaaaaaaaaaaaaeaeaeaeaeaaaaaaaaaaaaaaaaaaaaaaaaaaaaaaaaaaaaaaaaaaaaaaaaaaaaaaaaaaaaaaaaaaaaaaaaaaaaaaaaaaaaaaaaaaaaaaaaaaaaaaaaaa
aaaaaaaaaaaaaaaaaaaaaaaaaaaaaaaaaaaaaaaaaaaaaaaaaaaaaaaaaaaaaaaaaaaaaaaaaaaaaaaaaaaaaaaaaaaaaaaaaaaaaaaaaaaaaaaaaaaaaaaaaaaaaaaaaaaaaaaaaaaaaaaaaaaaaaaaaaaaaaaa
aaaaaaaaaaaaaaaaaaaaaaaaaaaaaaaaaaaaaaaaaaaaaaaaaaaaaaaaaaaaaaaaaaaaaaaaaaaaaaaaaaaaaaaaaaaaaaaaaaaaaaaaaaaaaaaaaaaaaaaBaBaBaBaBaBaBaBaBaBaBaBaBaBaBaBaaaaaaaaaa
aaaaaaaaaaaaaaaaaaaaaaaaaaaaaaaaaaaaaaaaaaaaaaaaaaaaaaaaaaaaaaaaaaaaaaaaaaaaaaaaaaaaaaaaaaaaaaaaaaaaaaaaaaaaaaaaaaaaaaaBaBaBaBaBaBaBaBaBaBaBaBaBaBaBaBaaaaaaaaaa
aaaaaaaaaaaaaaaaaaaaaaaaaaaaaaaaaaaaaaaaaaaaaaaaaaaaaaaaaaaaaaaaaaaaaaaaaaaaaaaaaaaaaaaaaaaaaaaaaaaaaaaaaaaaaaaaaaaaaaaBaBaBaBaBaBaBaBaBaBaBaBaBaBaBaBaaaaaaaaaa
aaaaaaaaaaaaaaaaaaaaaaaaaaaaaaaaaaaaaaaaaaaaaaaaaaaaaaaaaaaaaaaaaaaaaaaaaaaaaaaaaaaaaaaaaaaaaaaaaaaaaaaaaaaaaaaaaaaaaaaBaBaBaBaBaBaBaBaBaBaBaBaBaBaBaBaaaaaaaaaa
aaaaaaaaaaaaaaaaaaaaaaaaaaaaaaaaaaaaaaaaaaaaaaaaaaaaaaaaaaaaaaaaaaaaaaaaaaaaaaaaaaaaaaaaaaaaaaaaaaaaaaaaaaaaaaaaaaaaaaaBaBaBaBaBaBaBaBaBaBaBaBaBaBaBaBaaaaaaaaaa
aaaaaaaaaaaaaaaaaaaaaaaaaaaaaaaaaaaaaaaaaaaaaaaaaaaaaaaaaaaaaaaaaaaaaaaaaaaaaaaaaaaaaaaaaaaaaaaaaaaaaaaaaaaaaaaaaaaaaaaBaBaBaBaBaBaBaBaBaBaBaBaBaBaBaBaaaaaaaaaa
aaaaaaaaaaaaaaaaaaaaaaaaaaaaaaaaaaaaaaaaaaaaaaaaaaaaaaaaaaaaaaaaaaaaaaaaaaaaaaaaaaaaaaaaaaaaaaaaaaaaaaaaaaaaaaaaaaaaaaaBaBaBaBaBaBaBaBaBaBaBaBaBaBaBaBaaaaaaaaaa
aaaaaaaaaaaaaaaaaaaaaaaaaaaaaaaaaaaaaaaaaaaaaaaaaaaaaaaaaaaaaaaaaaaaaaaaaaaaaaaaaaaaaaaaaaaaaaaaaaaaaaaaaaaaaaaaaaaaaaaBaBaBaBaBaBaBaBaBaBaBaBaBaBaBaBaaaaaaaaaa
aaaaaaaaaaaaaaaaaaaaaaaaaaaaaaaaaaaaaaaaaaaaaaaaaaaaaaaaaaaaaaaaaaaaaaaaaaaaaaaaaaaaaaaaaaaaaaaaaaaaaaaaaaaaaaaaaaaaaaaBaBaBaBaBaBaBaBaBaBaBaBaBaBaBaBaaaaaaaaaa
aaaaaaaaaaaaaaaaaaaaaaaaaaaaaaabaaaaaaaaaaaaaaaaaaaaaaaaaaaaaaaaaaaaaaaaaaaaaaaaaaaaaaaaaaaaaaaaaaaaaaaaaaaaaaaaaaaaaaaBaBaBaBaBaBaBaBaBaBaBaBaBaBaBaBaaaaaaaaaa
aaaaaaaaaaaaaaaaaaaaaaaaaaaaaaaaaaaaaaaaaaaaaaaaaaaaaaaaaaaaaaaaaaaaaaaaaaaaaaaaaaaaaaaaaaaaaaaaaaaaaaaaaaaaaaaaaaaaaaaBaBaBaBaBaBaBaBaBaBaBaBaBaBaBaBaaaaaaaaaa
aaaaaaaaaaaaaaaaaaaaaaaaaaaaaaaaaaaaaaaaaaaaaaaaaaaaaaaaaaaaaaaaaaaaaaaaaaaaaaaaaaaaaaaaaaaaaaaaaaaaaaaaaaaaaaaaaaaaaaaBaBaBaBaBaBaBaBaBaBaBaBaBaBaBaBaaaaaaaaaa
aaaaaaaaaaaaaaaaaaaaaaaaaaaaaaaaaaaaaaaaaaaaaaaaaaaaaaaaaaaaaaaaaaaaaaaaaaaaaaaaaaaaaaaaaaaaaaaaaaaaaaaaaaaaaaaaaaaaaaaBaBaBaBaBaBaBaBaBaBaBaBaBaBaBaBaaaaaaaaaa
aaaaaaaaaaaaaaaaaaaaaaaaaaaaaaaaaaaaaaaaaaaaaaaaaaaaaaaaaaaaaaaaaaaaaaaaaaaaaaaaaaaaaaaaaaaaaaaaaaaaaaaaaaaaaaaaaaaaaaaBaBaBaBaBaBaBaBaBaBaBaBaBaBaBaBaaaaaaaaaa
aaaaaaaaaaaaaaaaaaaaaaaaaaaaaaaaaaaaaaaaaaaaaaaaaaaaaaaaaaaaaaaaaaaaaaaaaaaaaaaaaaaaaaaaaaaaaaaaaaaaaaaaaaaaaaaBaBaBaBaBaBaBaBaBaBaBaBaBaBaBaBaBaBaBaBaaaaaaaaaa
aaaaaaaaaaaaaaaaaaaaaaaaaaaaaaaaaaaaaaaaaaaaaaaaaaaaaaaaaaaaaaaaaaaaaaaaaaaaaaaaaaaaaaaaaaaaaaaaaaaaaaaaaaaaaaaBaBaBaBaBaBaBaBaBaBaBaBaBaBaBaBaBaBaBaBaaaaaaaaaa
aaaaaaaaaaaaaaaaaaaaaaaaaaaaaaaaaaaaaaaaaaaaaaaaaaaaaaaaaaaaaaaaaaaaaaaaaaaaaaaaaaaaaaaaaaaaaaaaaaaaaaaaaaaaaaaBaBaBaBaBaBaBaBaBaBaBaBaBaBaBaBaBaBaBaBaaaaaaaaaa
aaaaaaaaaaaaaaaaaaaaaaaaaaaaaaaaaaaaaaaaaaaaaaaaaaaaaaaaaaaaaaaaaaaaaaaaaaaaaaaaaaaaaaaaaaaaaaaaaaaaaaaaaaaaaaaBaBaBaBaBaBaBaBaBaBaBaBaBaBaBaBaBaBaBaBaaaaaaaaaa
aaaaaaaaaaaaaaaaaaaaaaaaaaaaaaaaaaaaaaaaaaaaaaaaaaaaaaaaaaaaaaaaaaaaaaaaaaaaaaaaaaaaaaaaaaaaaaaaaaaaaaaaaaaaaaaBaBaBaBaBaBaBaBaBaBaBaBaBaBaBaBaBaBaBaBaaaaaaaaaa
aaaaaaaaaaaaaaaaaaaaaaaaaaaaaaaaaaaaaaaaaaaaaaaaaaaaaaaaaaaaaaaaaaaaaaaaaaaaaaaaaaaaaaaaaaaaaaaaaaaaaaaaaaaaaaaBaBaBaBaBaBaBaBaBaBaBaBaBaBaBaBaBaBaBaBaaaaaaaaaa
aaaaaaaaaaaaaaaaaaaaaaaaaaaaaaaaaaaaaaaaaaaaaaaaaaaaaaaaaaaaaaaaaaaaaaaaaaaaaaaaaaaaaaaaaaaaaaaaaaaaaaaaaaaaaaaaaaaaaaaaaaaaaaaaaaaaaaaaaaaaaaaaaaaaaaaaaaaaaaaa
aaaaaaaaaaaaaaaaaaaaaaaaaaaaaaaaaaaaaaaaaaaaaaaaaaaaaaaaaaaaaaaaaaaaaaaaaaaaaaaaaaaaaaaaaaaaaaaaaaaaaaaaaaaaaaaaaaaaaaaaaaaaaaaaaaaaaaaaaaaaaaaaaaaaaaaaaaaaaaaa
aaaaaaaaaaaaaaaaaaaaaaaaaaaaaaaaaaaaaaaaaaaaaaaaaaaaaaaaaaaaaaaaaaaaaaaaaaaaaaaaaaaaaaaaaaaaaaaaaaaaaaaaaaaaaaaaaaaaaaaaaaaaaaaaaaaaaaaaaaaaaaaaaaaaaaaaaaaaaaaa
aaaaaaaaaaaaaaaaaaaaaaaaaaaaaaaaaaaaaaaaaaaaaaaaaaaaaaaaaaaaaaaaaaaaararararararararararararaaaaaaaaaaaaaaaaaaaaaaaaaaaaaaaaaaaaaaaaaaaaaaaaaaaaaaaaaaaaaaaaaaaa
aaaaaaaaaaaaaaaaaaaaaaaaaaaaaaaaaaaaaaaaaaaaaaaaaaaaaaaaaaaaaaaaaaaaararararararararararararaaaaaaaaaaaaaaaaaaaaaaaaaaaaaaaaaaaaaaaaaaaaaaaaaaaaaaaaaaaaaaaaaaaa
aaaaaaaaaaaaaaaaaaaaaaaaaaaaaaaaaaaaaaaaaaaaaaaaaaaaaaaaaaaaaaaaaaaaarasasasasasasasasasasaraaaaaaaaaaaaaaaaaaaaaaaaaaaaaaaaaaaaaaaaaaaaaaaaaaaaaaaaaaaaaaaaaaaa
aaaaaaaaaaaaaaaaaaaaaaaaaaaaaaaaaaaaaaaaaaaaaaaaaaaaaaaaaaaaaaaaaaaaarasasasasasasasasasasaraaaaaaaaaaaaaaaaaaaaaaaaaaaaaaaaaaaaaaaaaaaaaaaaaaaaaaaaaaaaaaaaaaaa
aaaaaaaaaaaaaaaaaaaaaaaaaaaaaaaaaaaaaaaaaaaaaaaaaaaaaaaaaaaaaaaaaaaaarasasasasasasasasasasaraaaaaaaaaaaaaaaaaaaaaaaaaaaaaaaaaaaaaaaaaaaaaaaaaaaaaaaaaaaaaaaaaaaa
abaaaaaaaaaaaaaaaaaaaaaaaaaaaaaaaaaaaaaaaaaaaaaaaaaaaaaaaaaaaaaaaaaaarasasasasasasasasasasaraaaaaaaaaaaaaaaaaaaaaaaaaaaaaaaaaaaaaaaaaaaaaaaaaaaaaaaaaaaaaaaaaaaa
ababaaaaaaaaaaaaaaaaaaaaaaaaaaaaaaaaaaaaaaaaaaaaaaaaaaaaaaaaaaaaaaaaarasasasasasasasasasasaraaaaaaaaaaaaaaaaaaaaaaaaaaaaaaaaaaaaaaaaaaaaaaaaaaaaaaaaaaaaaaaaaaaa
adaSaTaSaTaSaUaSaTaVadadadadadabaaaaaaaaaaaaaaaaaaaaaaaaaaaaaaaaaaaaarasasasasasasasasasasaraaaaaaaaaaaaaaaaaaaaaaaaaaaaaaaaaaaaaaaaaaaaaaaaaaaaaaaaaaaaaaaaaaaa
adaSaTaWaXaYaSaSaSaXaXaTaSadadabaaaaaaaaaaaaaaaaaaaaaaaaaaaaaaaaaaaaarasasasasasasasasasasaraaaaaaaaaaaaaaaaaaaaaaaaaaaaaaaaaaaaaaaaaaaaaaaaaaaaaaaaaaaaaaaaaaaa
aSadaSaSaZaZaSaSaXaSaSaSaSaWaXabaaaaaaaaaaaaaaaaaaaaaaaaaaaaaaaaaaaaarasasasasasasasasasasaraaaaaaaaaaaaaaaaaaaaaaaaaaaaaaaaaaaaaaaaaaaaaaaaaaaaaaaaaaaaaaaaaaaa
aWaSaSaYaYaTaSaSaWaXbaadaSbkaTabaaaaaaaaaaaaaaaaaaaaaaaaaaaaaaaaaaaaarasasasasasasasasasasaraaaaaaaaaaaaaaaaaaaaaaaaaaaaaaaaaaaaaaaaaaaaaaaaaaaaaaaaaaaaaaaaaaaa
adaSadaTaTaTaSaSadaSbbbaaSaTadabaaaaaaaaaaaaaaaaaaaaaaaaaaaaaaaaaaaaarasasasasasasasasasasaraaaaaaaaaaaaaaaaaaaaaaaaaaaaaaaaaaaaaaaaaaaaaaaaaaaaaaaaaaaaaaaaaaaa
bcbaaSaXaWaSaTadaTaTaSbaaSaTadabaaaaaaaaaaaaaaaaaaaaaaaaaaaaaaaaaaaaarasasasasasasasasasasaraaaaaaaaaaaaaaaaaaaaaaaaaaaaaaaaaaaaaaaaaaaaaaaaaaaaaaaaaaaaaaaaaaaa
aYbdaZaSaSaXaWaTaSaSaWbaadaSadabaiaiaiaiaiaiaiaiaiaiaiaiaiaiaiaiaraaarasasasasasasasasasasaraaaaaaaaaaaaaaaaaaaaaaaaaaaaaaaaaaaaaaaaaaaaaaaaaaaaaaaaaaaaaaaaaaaa
aZaXaWaSbkaTaXaTaSaSaXbaaXaSadabaiakakakakakakakakakakakakakakaiaraaarasasasasasasasasasasaraaaaaaaaaaaaaaaaaaaaaaaaaaaaaaaaaaaaaaaaaaaaaaaaaaaaaaaaaaaaaaaaaaaa
aXaSaXaSaSadaSaSaSbababaaWaSbjabaiakakakakakakakakakakakakakakaiaraaarasasasasasasasasasasaraaaaaaaaaaaaaaaaaaaaaaaaaaaaaaaaaaaaaaaaaaaaaaaaaaaaaaaaaaaaaaaaaaaa
aSaTaSadaSaSaSaWaSbaadadaSaSaTabaiakakakakakakakakakakakakakakaiaraaarasasasasasasasasasasaraaaaaaaaaaaaaaaaaaaaaaaaaaaaaaaaaaaaaaaaaaaaaaaaaaaaaaaaaaaaaaaaaaaa
aTaTaSaWaXaSaSaXbababeaWaZaSadabaiakakakakakakakakakakakakakakaiaraaarasasasasasasasasasasaraaaaaaaaaaaaaaaaaaaaaaaaaaaaaaaaaaaaaaaaaaaaaaaaaaaaaaaaaaaaaaaaaaaa
bbbbaSaTaTaTaZbjbababebeaZaSaWabaiakakakakakakakakakakakakakakaiaraaarasasasasasasasasasasaraaaaaaaaaaaaaaaaaaaaaaaaaaaaaaaaaaaaaaaaaaaaaaaaaaaaaaaaaaaaaaaaaaaa
bbadadaSaSaZaZaZbababababaaTaSabaiakakakakakakakakakakakakakakaiaraaarasasasasasasasasasasaraaaaaaaaaaaaaaaaaaaaaaaaaaaaaaaaaaaaaaaaaaaaaaaaaaaaaaaaaaaaaaaaaaaa
adadadaSaTaSadaSaSaSaWbabaadbiabaiakakakakakakakakakakakakakakaiaraaararararararararararararaaaaaaaaaaaaaaaaaaaaaaaaaaaaaaaaaaaaaaaaaaaaaaaaaaaaaaaaaaaaaaaaaaaa
adadadaTaTaSaWaXaSaSaXblbablababaiakakakakakakakakakakalakakakaiaraaararararararararararararaaaaaaaaaaaaaaaaaaaaaaaaaaaaaaaaaaaaaaaaaaaaaaaaaaaaaaaaaaaaaaaaaaaa
aXbcbabbbbaSaTaTaTaZbjblbablababaiakakakakakakakakakakakakakakaiaraaaaaaaaaaaaaaaaaaaaaaaaaaaaaaaaaaaaaaaaaaaaaaaaaaaaaaaaaaaaaaaaaaaaaaaaaaaaaaaaaaaaaaaaaaaaaa
aWbcbbbbadadaSaSaZaZaZblbablababaiakakakakakakakakakakakakakakaiaraaaaaaaaaaaaaaaaaaaaaaaaaaaaaaaaaaaaaaaaaaaaaaaaaaaaaaaaaaaaaaaaaaaaaaaaaaaaaaaaaaaaaaaaaaaaaa
aSadbaaXaSaXaWaSaZaWaXblbabmababaiakakakakakakakakakakakakakakaiarararararararaaaaaaaaaaaaaaaaaaaaaaaaaaaaaaaaaaaaaaaaaaaaaaaaaaaaaaaaaaaaaaaaaaaaaaaaaaaaaaaaaa
aSbbbaaWaSaSaZaZaZaZaXbabablababaiakakakakakakakakakakakakakakaiarararararararaaaaaaaaaaaaaaaaaaaaaaaaaaaaaaaaaaaaaaaaaaaaaaaaaaaaaaaaaaaaaaaaaaaaaaaaaaaaaaaaaa
aSaSbaaTaTaSbeabababaWbababmababaiakakakakakakakakakakakakakanaiararararaaaaaaaaaaaaaaaaaaaaaaaaaaaaaaaaaaaaaaaaaaaaaaaaaaaaaaaaaaaaaaaaaaaaaaaaaaaaaaaaaaaaaaaa
aSaSaSaSaSaSabababbabababmbiababaiakakakakakakakakakakakakaoaoaqararararaaaaaaaaaaaaaaaaaaaaaaaaaaaaaaaaaaaaaaaaaaaaaaaaaaaaaaaaaaaaaaaaaaaaaaaaaaaaaaaaaaaaaaaa
aWaXaSaSaSaWabaWbabababmblabababaiakakakakakakakakakakakakaoaoaqararararaaaaaaaaaaaaaaaaaaaaaaaaaaaaaaaaaaaaaaaaaaaaaaaaaaaaaaaaaaaaaaaaaaaaaaaaaaaaaaaaaaaaaaaa
aTaXaSaSaWababaXbfbhbgbmblababaaaiakakakakakakakakakakakakaoaoaqararararaaaaaaaaaaaaaaaaaaaaaaaaaaaaaaaaaaaaaaaaaaaaaaaaaaaaaaaaaaaaaaaaaaaaaaaaaaaaaaaaaaaaaaaa
abababababababababababababababaaaiakakakakakakakakakakakakakanaiararaaaaaaaaaaaaaaaaaaaaaaaaaaaaaaaaaaaaaaaaaaaaaaaaaaaaaaaaaaaaaaaaaaaaaaaaaaaaaaaaaaaaaaaaaaaa
aaaaaaaaaaaaaaaaaaaaaaaaaaaaaaaaaiakakakakakakakakakakakakakakaiararaaaaaaaaaaaaaaaaaaaaaaaaaaaaaaaaaaaaaaaaaaaaaaaaaaaaaaaaaaaaaaaaaaaaaaaaaaaaaaaaaaaaaaaaaaaa
aaaaaaaaaaaaaaaaaaaaaaaaaaaaaaaaaiakakakakakakakakakakakakakakaiararaaaaaaaaaaaaaaaaaaaaaaaaaaaaaaaaaaaaaaaaaaaaaaaaaaaaaaaaaaaaaaaaaaaaaaaaaaaaaaaaaaaaaaaaaaaa
aaaaaaaaaaaaaaaaaaaaaaaaaaaaaaaaaiakakakakakakakakakakakakakakaiaraaaaaaaaaaaaaaaaaaaaaaaaaaaaaaaaaaaaaaaaaaaaaaaaaaaaaaaaaaaaaaaaaaaaaaaaaaaaaaaaaaaaaaaaaaaaaa
aaaaaaaaaaaaaaaaaaaaaaaaaaaaaaaaaiaiaiaiaiaiaiaiaiaiaiaiaiaiaiaiaraaaaaaaaaaaaaaaaaaaaaaaaaaaaaaaaaaaaaaaaaaaaaaaaaaaaaaaaaaaaaaaaaaaaaaaaaaaaaaaaaaaaaaaaaaaaaa
aaaaaaaaaaaaaaaaaaaaaaaaaaaaaaaaaaaaaaaaaaaaaaaaaaaaaaaaaaaaaaaaaaaaaaaaaaaaaaaaaaaaaaaaaaaaaaaaaaaaaaaaaaaaaaaaaaaaaaaaaaaaaaaaaaaaaaaaaaaaaaaaaaaaaaaaaaaaaaaa
aaaaaaaaaaaaaaaaaaaaaaaaaaaaaaaaaaaaaaaaaaaaaaaaaaaaaaaaaaaaaaaaaaaaaaaaaaaaaaaaaaaaaaaaaaaaaaaaaaaaaaaaaaaaaaaaaaaaaaaaaaaaaaaaaaaaaaaaaaaaaaaaaaaaaaaaaaaaaaaa
aaaaaaaaaaaaaaaaaaaaaaaaaaaaaaaaaaaaaaaaaaaaaaaaaaaaaaaaaaaaaaaaaaaaaaaaaaaaaaaaaaaaaaaaaaaaaaaaaaaaaaaaaaaaaaaaaaaaaaaaaaaaaaaaaaaaaaaaaaaaaaaaaaaaaaaaaaaaaaaa
aaaaaaaaaaaaaaaaaaaaaaaaaaaaaaaaaaaaaaaaaaaaaaaaaaaaaaaaaaaaaaaaaaaaaaaaaaaaaaaaaaaaaaaaaaaaaaaaaaaaaaaaaaaaaaaaaaaaaaaaaaaaaaaaaaaaaaaaaaaaaaaaaaaaaaaaaaaaaaaa
aaaaaaaaaaaaaaaaaaaaaaaaaaaaaaaaaaaaaaaaaaaaaaaaaaaaaaaaaaaaaaaaaaaaaaaaaaaaaaaaaaaaaaaaaaaaaaaaaaaaaaaaaaaaaaaaaaaaaaaaaaaaaaaaaaaaaaaaaaaaaaaaaaaaaaaaaaaaaaaa
aaaaaaaaaaaaaaaaaaaaaaaaaaaaaaaaaaaaaaaaaaaaaaaaaaaaaaaaaaaaaaaaaaaaaaaaaaaaaaaaaaaaaaaaaaaaaaaaaaaaaaaaaaaaaaaaaaaaaaaaaaaaaaaaaaaaaaaaaaaaaaaaaaaaaaaaaaaaaaaa
"}
