"a" = (/turf/closed/wall/mineral/wood,/area/maintenance/polovich/forest/rain)
"b" = (/turf/open/floor/plating/polovich/newstoneawesome/big,/area/maintenance/polovich/forest/rain)
"c" = (/obj/structure/railing{dir = 8},/turf/open/floor/plating/polovich/newstoneawesome,/area/maintenance/polovich/forest/rain)
"d" = (/turf/closed/wall/darkrock,/area/maintenance/polovich/forest/rain)
"e" = (/obj/structure/stairs/north,/turf/open/floor/plating/polovich/newstoneawesome,/area/maintenance/polovich/forest/rain)
"f" = (/turf/closed/wall/purple/nocling,/area/maintenance/polovich/forest/rain)
"g" = (/turf/open/openspace/norm,/area/maintenance/polovich/forest/rain)
"h" = (/turf/open/floor/plating/polovich/rockedar,/area/maintenance/polovich/forest/rain)
"i" = (/turf/open/floor/plating/polovich/dirt/soft,/area/maintenance/polovich/forest/rain)
"j" = (/turf/closed/wall/r_wall/alt/nocling,/area/maintenance/polovich/forest/rain)
"k" = (/turf/open/floor/plating/polovich/logsgreen,/area/maintenance/polovich/forest/rain)
"l" = (/turf/open/floor/plating/polovich/logsgreen{dir = 8},/area/maintenance/polovich/forest/rain)
"m" = (/turf/closed/wall/r_wall/rusty/nocling,/area/maintenance/polovich/forest/rain)
"n" = (/turf/open/floor/plating/polovich/metalnoble/second,/area/maintenance/polovich/forest/rain)
"o" = (/turf/open/floor/plating/polovich/typaya,/area/maintenance/polovich/forest/rain)
"p" = (/turf/open/floor/plating/polovich/greenstone,/area/maintenance/polovich/forest/rain)
"q" = (/obj/structure/ladder{down = 1},/turf/open/floor/plating/polovich/newstoneawesome,/area/maintenance/polovich/forest/rain)
"r" = (/turf/open/floor/plating/polovich/newstoneawesome,/area/maintenance/polovich/forest/rain)
"s" = (/obj/structure/fermenting_barrel/water,/turf/open/floor/plating/polovich/logsgreen,/area/maintenance/polovich/forest/rain)
"t" = (/turf/open/floor/plating/polovich/logsgreen/two,/area/maintenance/polovich/forest/rain)
"u" = (/obj/structure/stairs/south,/turf/open/floor/plating/polovich/logsgreen/two,/area/maintenance/polovich/forest/rain)
"v" = (/obj/structure/fermenting_barrel/water,/turf/open/floor/plating/polovich/newstoneawesome,/area/maintenance/polovich/forest/rain)
"w" = (/obj/structure/table/reinforced,/turf/open/floor/plating/polovich/newstoneawesome,/area/maintenance/polovich/forest/rain)
"x" = (/turf/open/floor/plating/polovich/newstoneawesome/dirty,/area/maintenance/polovich/forest/rain)

(1,1,1) = {"
fffffffffffffffffffffffffffffffffffffffffffffffffffffffffffffffffffffffffffffffffffffffffffffffffffffffffffffffffffffffffffffffffffffffffffffffffffffffffffffffffffffffffffffffffffffffff
fgggggggggggggggggggggggggggggggggggggggggggggggggggggggggggggggggggggggggggggggggggggggggggggggggggggggggggggggggggggffgggggggggggggffffffffffffffffffffffffffffffffffffffffffffffffffff
fgggggggggggggggggggggggggggggggggggggggggggggggggggggggggggggggggggggggggggggggggggggggggggggggggggggggggggggggggggggffgggggggggggggffffffffffffffffffffffffffffffffffffffffffffffffffff
fgggggggggggggggggggggggggggggggggggggggggggggggggggggggggggggggggggggggggggggggggggggggggggggggggggggggggggggggggggggffgggggggggggggffrrrrrrrrrrrrrrrrrrrrrrrrrrrrrrrrrrrrrrrrrrrrrrffff
fgggggggggggggggggggggggggggggggggggggggggggggggggggggggggggggggggggggggggggggggggggggggggggggggggggggggggggggggggggggffgggggggggggggffraaaaaaaaaaaaaaaaaaarrrddddddddddddddddddddddrffff
fgggggggggggggggggggggggggggggggggggggggggggggggggggggggggggggggggggggggggggggggggggggggggggggggggggggggggggggggggggggffgggggggggggggffrakkkksakkkksakkkksarrrdrrrrdrrrrrrrrdrrddrrdrffff
fgggggggggggggggggggggggggggggggggggggggggggggggggggggggggggggggggggggggggggggggggggggggggggggggggggggggggggggggggggggffgggggggggggggffratttttatttttatttttarrrdrrrrrrrrrrrrrrrrddrrdrffff
fgggggggggggggggggggggggggggggggggggggggggggggggggggggggggggggggggggggggggggggggggggggggggggggggggggggggggggggggggggggffgggggggggggggffratttttatttttatttttarrrdrrrrdrrrrrrrrdrreerrdrffff
fgggggggggggggggggggggggggggggggggggggggggggggggggggggggggggggggggggggggggggggggggggggggggggggggggggggggggggggggggggggffgggggggggggggffrattttuattttuattttuarrbddwwdddddddddddrrrrrrdrffff
fgggggggggggggggggggggggggggggggggggggggggggggggggggggggggggggggggggggggggggggggggggggggggggggggggggggggggggggggggggggffgggggggggggggffrattttaattttaattttaarrbdrrrrdrrrrrrrrdrrrrrrdrffff
fgggggggggggggggggggggggggggggggggggggggggggggggggggggggggggggggggggggggggggggggggggggggggggggggggggggggggggggggggggggffgggggggggggggffralaaaaalaaaaalaaaaarbbdrrrrrrrrrrrrrrrrrrrrdrffff
fgggggggggggggggggggggggggggggggggggggggggggggggggggggggggggggggggggggggggggggggggggggggggggggggggggggggggggggggggggggffgggggggggggggffrrrrrrrrrrrrrrrrrrrrrbbdrrdddrrrrrrrrdrrrrrrdrffff
fgggggggggggggggggggggggggggggggggggggggggggggggggggggggggggggggggggggggggggggggggggggggggggggggggggggggggggggggggggggffggggggggggggggrrrrrrrrrrrrrrrrrrrrrrbbdrrdddddddddddddddddddrffff
fgggggggggggggggggggggggggggggggggggggggggggggggggggggggggggggggggggggggggggggggggggggggggggggggggggggggggggggggggggggffggggggggggggggrrrrrrrrrrrrrrrrrrrrrrrbbrrrrbbbbbbbbbbrrrrrrrrffff
fgggggggggggggggggggggggggggggggggggggggggggggggggggggggggggggggggggggggggggggggggggggggggggggggggggggggggggggggggggggffggggggggggggggrrrrrrrrrrrrrrrrrrrrrrrrrrrrrrbbbbbbbbbrrrrrrrrffff
fgggggggggggggggggggggggggggggggggggggggggggggggggggggggggggggggggggggggggggggggggggggggggggggggggggggggggggggggggggggffgggggggggggggffrrrrffffffffffffffffffffbbbbbrbbrrrrbbrrrrrrrrffff
fgggggggggggggggggggggggggggggggggggggggggggggggggggggggggggggggggggggggggggggggggggggggggggggggggggggggggggggggggggggffgggggggggggggffrrrrffffffffffffffffffffbrbfffffffffffffffffffffff
fgggggggggggggggggggggggggggggggggggggggggggggggggggggggggggggggggggggggggggggggggggggggggggggggggggggggggggggggggggggffgggggggggggggffrrrrffggggggggggggggggffrbrfffffffffffffffffffffff
fgggggggggggggggggggggggggggggggggggggggggggggggggggggggggggggggggggggggggggggggggggggggggggggggggggggggggggggggggggggffgggggggggggggffrrrrffggggggggggggggggffbrbfffffffffffffffffffffff
fgggggggggggggggggggggggggggggggggggggggggggggggggggggggggggggggggggggggggggggggggggggggggggggggggggggggggggggggggggggffgggggggggggggffrrrrffggggggggggggggggffrbrfffffffffffffffffffffff
fgggggggggggggggggggggggggggggggggggggggggggggggggggggggggggggggggggggggggggggggggggggggggggggggggggggggggggggggggggggffgggggggggggggffrrrrffggggggggggggggggffrrrfffffffffffffffffffffff
fgggggggggggggggggggggggggggggggggggggggggggggggggggggggggggggggggggggggggggggggggggggggggggggggggggggggggggggggggggggffgggggggggggggffrrrrffggggggggggggggggrrrrrfffffffffffffffffffffff
fgggggggggggggggggggggggggggggggggggggggggggggggggggggggggggggggggggggggggggggggggggggggggggggggggggggggggggggggggggggffgggggggggggggffrrrrffggggggggggggggggrrrrrfffffffffffffffffffffff
fgggggggggggggggggggggggggggggggggggggggggggggggggggggggggggggggggggggggggggggggggggggggggggggggggggggggggggggggggggggffgggggggggggggffrrrrffggggggggggggggggrrrrrfffffffffffffffffffffff
fgggggggggggggggggggggggggggggggggggggggggggggggggggggggggggggggggggggggggggggggggggggggggggggggggggggggggggggggggggggffgggggggggggggffrrrrffggggggggggggggggmmrrrmmfffffffffffffffffffff
fgggggggggggggggggggggggggggggggggggggggggggggggggggggggggggggggggggggggggggggggggggggggggggggggggggggggggggggggggggggffffffffffffgggffrrrrffggggggggggggggggmmrrrmmfffffffffffffffffffff
fggggggggggggggggggggggggggggggggggggggggggggggggggggggggggggggggggggggggggggggggggggggggggggggggggggggggggggggggggggggffffffffffffggffrrrrffggggggggggggggggmmrrrmmjjjjjjjjjjjjjjjjjjjjf
fggggggggggggggggggggggggggggggggggggggggggggggggggggggggggggggggggggggggggggggggggggggggggggggggggggggggggggggggggggggggggggcrriifffffbrrrffggggggggggggggggmkkkkkkjjjjjkkkkkkkkkjjjjjjf
fggggggggggggggggggggggggggggggggggggggggggggggggggggggggggggggggggggggggggggggggggggggggggggggggggggggggggggggggggggggggggggcrrxifffffbrrrffggggggggggggggggkkkkkkkjjjjjkkkkkkkkkjjjjjjf
fggggggggggggggggggggggggggggggggggggggggggggggggggggggggggggggggggggggggggggggggggggggggggggggggggggggggggggggggggggggggggggrrrrrrrbbbbbrrffggggggggggggggggmkkkkkkkkkkkkkkkkkkkkkkkkkjf
fggggggggggggggggggggggggggggggggggggggggggggggggggggggggggggggggggggggggggggggggggggggggggggggggggggggggggggggggggggggggggggrbbbrrrrbbbrrrffggggggggggggggggkkkkkkkkkkkkkkkkkkkkkkkkkkjf
fggggggggggggggggggggggggggggggggggggggggggggggggggggggggggggggggggggggggggggggggggggggggggggggggggggggggggggggggggggggggggggrbbbrrrrrrrrrrffggggggggggggggggmkkkkkkjjjjjkkkkkkkkkjjjkkjf
fggggggggggggggggggggggggggggggggggggggggggggggggggggggggggggggggggggggggggggggggggggggggggggggggggggggggggggggggggggggggggggrbbrrrrrrrrrrrffggggggggggggggggkkkkkkkjjjjjkkkkkkkkkjjjkkjf
fggggggggggggggggggggggggggggggggggggggggggggggggggggggggggggggggggggggggggggggggggggggggggggggggggggggggggggggggggggggggggggcbbbrfffffrrrrffggggggggggggggggmjkkjjjjjjjjkkkkkkkkkjjjkkjf
fggggggggggggggggggggggggggggggggggggggggggggggggggggggggggggggggggggggggggggggggggggggggggggggggggggggggggggggggggggggggggggcbbbrfffffrrrrffggggggggggggggggmjkkjjjjjjjjjjjjjjjjjjjjkkjf
fggggggggggggggggggggggggggggggggggggggggggggggggggggggggggggggggggggggggggggggggggggggggggggggggggggggggggggggggggggggggggggcrrrrfffffrrrrffggggggggggggggggmmkkjjjjjjjjjjjjjjjjjjjjkkjf
fggggggggggggggggggggggggggggggggggggggggggggggggggggggggggggggggggggggggggggggggggggggggggggggggggggggggggggggggggggggggggggfrrfffffffrrrrffggggggggggggggggkkkkjjjjjjjjjjjjkkkkkkkkkkjf
fggggggggggggggggggggggggggggggggggggggggggggggggggggggggggggggggggggggggggggggggggggggggggggggggggggggggggggggggggggggggggggfrrfffffffrrrrffggggggggggggggggkkkkjjjjjjjjjjjjkkkkkkkkkkjf
fggggggggggggggggggggggggggggggggggggggggggggggggggggggggggggggggggggggggggggggggggggggggggggggggggggggggggggggggggggggggggggfrrfffffffrrrrffggggggggggggggggmmkkkkkkkkkkkkkkkkkkkkkkkkjf
fggggggggggggggggggggggggggggggggggggggggggggggggggggggggggggggggggggggggggggggggggggggggggggggggggggggggggggggggggggggggggggfqqffffffrrrrrffggggggggggggggggmjkkkkkkkkkkkkkkkkkkkkkkkkjf
fggggggggggggggggggggggggggggggggggggggggggggggggggggggggggggggggggggggggggggggggggggggggggggggggggggggggggggggggggggggggggggfffffffffrrrrrffggggggggggggggggmjkkkkkkkkkkkkjjkkkkkkkkkkjf
fggggggggggggggggggggggggggggggggggggggggggggggggggggggggggggggggggggggggggggggggggggggggggggggggggggggggggggggggggggggggggggfffffffffrrrrrffggggggggggggggggjjkkkkkkkkkkkkjjkkkkkkkkkkjf
fggggggggggggggggggggggggggggggggggggggggggggggggggggggggggggggggggggggggggggggggggggggggggggggggggggggggggggggggggggggggggggffffffffffrrrrffggggggggggggggggjjkkkkkkkkkkkkjjkkkkkkkkkkjf
fggggggggggggggggggggggggggggggggggggggggggggggggggggggggggggggggggggggggggggggggggggggggggggggggggggggggggggggggggggggggggggffffffffffrrrrffggggggggggggggggjjkkkkkkkkkkkkjjkkkkkkkkkkjf
fggggggggggggggggggggggggggggggggggggggggggggggggggggggggggggggggggggggggggggggggggggggggggggggggggggggggggggggggggggggggggggaaaaaaaaaarrrrffggggggggggggggggjjjjjkkjjjjjjjjjjjjjjjjjjjjf
fggggggggggggggggggggggggggggggggggggggggggggggggggggggggggggggggggggggggggggggggggggggggggggggggggggggggggggggggggggggggggggarrrarrrrarrrrffggggggggggggggggjjjjjkkjjjjjjjjjjjjjjjjjjjjf
fggggggggggggggggggggggggggggggggggggggggggggggggggggggggggggggggggggggggggggggggggggggggggggggggggggggggggggggggggggggggggggarrrarrrrarrrrffggggggggggggggggjjkkkkkkkkkkkkkjjkkkkkkkkjjf
fggggggggggggggggggggggggggggggggggggggggggggggggggggggggggggggggggggggggggggggggggggggggggggggggggggggggggggggggggggggggggggarrrarrrrarrrrffggggggggggggggggjjkkkkkkkkkkkkkjjkkkkkkkkjjf
fggggggggggggggggggggggggggggggggggggggggggggggggggggggggggggggggggggggggggggggggggggggggggggggggggggggggggggggggggggggggggggarrrwrrrrrrrrrffggggggggggggggggjjkkkkkkkkkkkkkkkkkkkkkkkjjf
fggggggggggggggggggggggggggggggggggggggggggggggggggggggggggggggggggggggggggggggggggggggggggggggggggggggggggggggggggggggggggggarrrwrrrrrrrrrffggggggggggggggggjjkkkkkkkkkkkkkkkkkkkkkkkjjf
fggggggggggggggggggggggggggggggggggggggggggggggggggggggggggggggggggggggggggggggggggggggggggggggggggggggggggggggggggggggggggggarrrarrrrrhhhhffggggggggggggggggjjkkkkkkkkkkkkkjjkkkkkkkkjjf
fggggggggggggggggggggggggggggggggggggggggggggggggggggggggggggggggggggggggggggggggggggggggggggggggggggggggggggggggggggggggggggarrrrrrrrahhhhffggggggggggggggggjjkkkkkkkkkkkkkjjkkkkkkkkjjf
fggggggggggggggggggggggggggggggggggggggggggggggggggggggggggggggggggggggggggggggggggggggggggggggggggggggggggggggggggggggggggggarraaaaaaahhhhffggggggggggggggggjjkkkkkkkkkkkkkjjkkkkkkkkjjf
fggggggggggggggggggggggggggggggggggggggggggggggggggggggggggggggggggggggggggggggggggggggggggggggggggggggggggggggggggggggggggggarrrrrrrrahhhhffggggggggggggggggjjkkkkkkkkkkkkkjjkkkkkkkkjjf
fggggggggggggggggggggggggggggggggggggggggggggggggggggggggggggggggggggggggggggggggggggggggggggggggggggggggggggggggggggggggggggarrrrrrrrarrrrffggggggggggggggggjjjjjjjkkjjjjjjjjjjjjjjjjjjf
fggggggggggggggggggggggggggggggggggggggggggggggggggggggggggggggggggggggggggggggggggggggggggggggggggggggggggggggggggggggggggggarrrrrrrrahhhhffggggggggggggggggjjjjjjjkkjjjjjjjjjjjjjjjjjjf
fggggggggggggggggggggggggggggggggggggggggggggggggggggggggggggggggggggggggggggggggggggggggggggggggggggggggggggggggggggggggggggarraaaaaaahhhhffggggggggggggggggfffffjkkkkjfffffffffffffffff
fggggggggggggggggggggggggggggggggggggggggggggggggggggggggggggggggggggggggggggggggggggggggggggggggggggggggggggggggggggggggggggarrrrrrrrarrhrffggggggggggggggggfffffjkkkkjfffffffffffffffff
fggggggggggggggggggggggggggggggggggggggggggggggggggggggggggggggggggggggggggggggggggggggggggggggggggggggggggggggggggggggggggggarrrrrrrrahhhhffggggggggggggggggfffffjkkkkjfffffffffffffffff
fggggggggggggggggggggggggggggggggggggggggggggggggggggggggggggggggggggggggggggggggggggggggggggggggggggggggggggggggggggggggggggarrrrrrrrahhhhffggggggggggggggggfffffmkkkkmfffffffffffffffff
fggggggggggggggggggggggggggggggggggggggggggggggggggggggggggggggggggggggggggggggggggggggggggggggggggggggggggggggggggggggggggggaaaaaaaaaarhhraaggggggggggggggggfffffmmkkkmfffffffffffffffff
fggggggggggggggggggggggggggggggggggggggggggggggggggggggggggggggggggggggggggggggggggggggggggggggggggggggggggggggggggggggggggggfrrrggrhhhhhhhrrggggggggggggggggfffffmonnomfffffffffffffffff
fggggggggggggggggggggggggggggggggggggggggggggggggggggggggggggggggggggggggggggggggggggggggggggggggggggggggggggggggggggggggggggfrrrggrrhhhhhhrrggggggggggggggggfffffmnnnnmfffffffffffffffff
fggggggggggggggggggggggggggggggggggggggggggggggggggggggggggggggggggggggggggggggggggggggggggggggggggggggggggggggggggggggggggggfrrrggrrrhhhhhrrgggggggggggggggggffffmonnomfffffffffffffffff
fggggggggggggggggggggggggggggggggggggggggggggggggggggggggggggggggggggggggggggggggggggggggggggggggggggggggggggggggggggggggggggfrrrggrrrrrrrraaggggggggggggggggggggfmmppmmfffffffffffffffff
fggggggggggggggggggggggggggggggggggggggggggggggggggggggggggggggggggggggggggggggggggggggggggggggggggggggggggggggggggggggggggggfrrrggrrrrrrrrffggggggggggggggggggggffppppffffffffffffffffff
fggggggggggggggggggggggggggggggggggggggggggggggggggggggggggggggggggggggggggggggggggggggggggggggggggggggggggggggggggggggggggggrrrrhhrrrrrrrrffggggggggggggggggggggffppppffffffffffffffffff
fggggggggggggggggggggggggggggggggggggggggggggggggggggggggggggggggggggggggggggggggggggggggggggggggggggggggggggggggggggggggggggrrrrhhrrrrrrrrffggggggggggggggggggggffppppffffffffffffffffff
fggggggggggggggggggggggggggggggggggggggggggggggggggggggggggggggggggggggggggggggggggggggggggggggggggggggggggggggggggggggggggggrrrrhhrrrrrrrrffffffffarrrafffffffffffrpprffffffffffffffffff
fggggggggggggggggggggggggggggggggggggggggggggggggggggggggggggggggggggggggggggggggggggggggggggggggggggggggggggggggggggggggggggfrrrggrrrrrrrrffffffffarrraffffffffffppppppffaaaaaaaaaaaaaff
fggggggggggggggggggggggggggggggggggggggggggggggggggggggggggggggggggggggggggggggggggggggggggggggggggggggggggggggggggggggggggggfrrrggrrrrrrrrrrrrrrrrrrrrrrrrrrrrrrrrrrrrrrrrrrrrrrrrrrraff
fggggggggggggggggggggggggggggggggggggggggggggggggggggggggggggggggggggggggggggggggggggggggggggggggggggggggggggggggggggggggggggfrrrggrrrrrrrrrrrrrrrrrrrrrrrrrrrrrrrrrrrrrrrrrrrrrrrrrrraff
fggggggggggggggggggggggggggggggggggggggggggggggggggggggggggggggggggggggggggggggggggggggggggggggggggggggggggggggggggggggggggggfrrrggrrrrrrrrrrrrrrrrrrrrrrrrrrrrrrrrrrrrrrrrrrrrrrrrrrraff
fggggggggggggggggggggggggggggggggggggggggggggggggggggggggggggggggggggggggggggggggggggggggggggggggggggggggggggggggggggggggggggfrrrggrrrrrrrrrrrrrrrrrrrrrrrrrrrrrrrrrrrrrrrarrrrrrrrrrraff
fggggggggggggggggggggggggggggggggggggggggggggggggggggggggggggggggggggggggggggggggggggggggggggggggggggggggggggggggggggggggggggfrrrggrrrrrrrrffrrrrffrrrrrrrrrrrrrrffrrrrfffaaarrrrrrrrraff
fggggggggggggggggggggggggggggggggggggggggggggggggggggggggggggggggggggggggggggggggggggggggggggggggggggggggggggggggggggggggggggfffffffrrrrrrrffrrrrffrrrrrrrrrrrrrrffrrrrfffffarrrrrrrrraff
fggggggggggggggggggggggggggggggggggggggggggggggggggggggggggggggggggggggggggggggggggggggggggggggggggggggggggggggggggggggggggggfffffffrrrrrrrffrrrrffrrrffffrrrrrrrffrrrrfffffarrrrrrrrraff
fggggggggggggggggggggggggggggggggggggggggggggggggggggggggggggggggggggggggggggggggggggggggggggggggggggggggggggggggggggggggggggfffffffrrrrrrrffggggfffffffffrrrrrrrffrrrrfffffarrrrrrrrraff
fggggggggggggggggggggggggggggggggggggggggggggggggggggggggggggggggggggggggggggggggggggggggggggggggggggggggggggggggggggggggggggffffffffffffffffggggfffffffffrrrrrrrffrrrrfffffarrrrrrrrraff
fggggggggggggggggggggggggggggggggggggggggggggggggggggggggggggggggggggggggggggggggggggggggggggggggggggggggggggggggggggggggggggffffffffffffffffggggffffffffrrrrrrrrffrrrrfffffarrrrrrrrraff
fggggggggggggggggggggggggggggggggggggggggggggggggggggggggggggggggggggggggggggggggggggggggggggggggggggggggggggggggggggggggggggffffgggggggggggggggggggggggfrrrrrrrrffrrrrfffffaaaaaaaaaaaff
fggggggggggggggggggggggggggggggggggggggggggggggggggggggggggggggggggggggggggggggggggggggggggggggggggggggggggggggggggggggggggggffffgggggggggggggggggggggggffrrrrrrfffrrrrffffffffffffffffff
fggggggggggggggggggggggggggggggggggggggggggggggggggggggggggggggggggggggggggggggggggggggggggggggggggggggggggggggggggggggggggggffffgggggggggggggggggggggggfffffffffffrrrrffffffffffffffffff
fggggggggggggggggggggggggggggggggggggggggggggggggggggggggggggggggggggggggggggggggggggggggggggggggggggggggggggggggggggggggggggffffgggggggggggggggggggggggfffffffffffrrrrffffffffffffffffff
fggggggggggggggggggggggggggggggggggggggggggggggggggggggggggggggggggggggggggggggggggggggggggggggggggggggggggggggggggggggggggggffffgggggggggggggggggggggggfffffffffffrrrrffffffffffffffffff
fggggggggggggggggggggggggggggggggggggggggggggggggggggggggggggggggggggggggggggggggggggggggggggggggggggggggggggggggggggggggggggffffgggggggggggggggggggggggfffffffffffrrrrffffffffffffffffff
fggggggggggggggggggggggggggggggggggggggggggggggggggggggggggggggggggggggggggggggggggggggggggggggggggggggggggggggggggggggggggggffffgggggggggggggggggggggggfffffffffffrrrrffffffffffffffffff
fggggggggggggggggggggggggggggggggggggggggggggggggggggggggggggggggggggggggggggggggggggggggggggggggggggggggggggggggggggggggggggffffgggggggggggggggggggggggfffffffffffrrrrffffffffffffffffff
fggggggggggggggggggggggggggggggggggggggggggggggggggggggggggggggggggggggggggggggggggggggggggggggggggggggggggggggggggggggggggggffffgggggggggggggggggggggggfffffffffffrrrrffffffffffffffffff
fggggggggggggggggggggggggggggggggggggggggggggggggggggggggggggggggggggggggggggggggggggggggggggggggggggggggggggggggggggggggggggffffgggggggggggggggggggggggffffffrrrrrrrrrrrrrrrrrrfffffffff
fggggggggggggggggggggggggggggggggggggggggggggggggggggggggggggggggggggggggggggggggggggggggggggggggggggggggggggggggggggggggggggffffgggggggggggggggggggggggffffffrrrrrrrrrrrrrrrrrrfffffffff
fggggggggggggggggggggggggggggggggggggggggggggggggggggggggggggggggggggggggggggggggggggggggggggggggggggggggggggggggggggggggggggffffgggggggggggggggggggggggffffffrrrrrrraraaaaaaaaafffffffff
fggggggggggggggggggggggggggggggggggggggggggggggggggggggggggggggggggggggggggggggggggggggggggggggggggggggggggggggggggggggggggggffffgggggggggggggggggggggggfffffrrrrrrrrarrrrrvvvrafffffffff
fggggggggggggggggggggggggggggggggggggggggggggggggggggggggggggggggggggggggggggggggggggggggggggggggggggggggggggggggggggggggggggffffgggggggggggggggggggggggggrrrrrrrrrrrarrrrrrrrrafffffffff
fggggggggggggggggggggggggggggggggggggggggggggggggggggggggggggggggggggggggggggggggggggggggggggggggggggggggggggggggggggggggggggffffgggggggggggggggggggggggggrrrrrrrrrrrarrrrrrrrrafffffffff
fggggggggggggggggggggggggggggggggggggggggggggggggggggggggggggggggggggggggggggggggggggggggggggggggggggggggggggggggggggggggggggffffgggggggggggggggggggggggffrrrrrrrrrrrarrrraaaaaafffffffff
fggggggggggggggggggggggggggggggggggggggggggggggggggggggggggggggggggggggggggggggggggggggggggggggggggggggggggggggggggggggggggggffffgggggggggggggggggggggggfffaaaaaaaaaaarrrrarfffffffffffff
fggggggggggggggggggggggggggggggggggggggggggggggggggggggggggggggggggggggggggggggggggggggggggggggggggggggggggggggggggggggggggggffffgggggggggggggggggggggggfffarrrrrarrrrrrrrarfffffffffffff
fggggggggggggggggggggggggggggggggggggggggggggggggggggggggggggggggggggggggggggggggggggggggggggggggggggggggggggggggggggggggggggffffgggggggggggggggggggggggfffarrrrrarrrrrrrrrrfffffffffffff
fggggggggggggggggggggggggggggggggggggggggggggggggggggggggggggggggggggggggggggggggggggggggggggggggggggggggggggggggggggggggggggffffgggggggggggggggggggggggfffarrrrrrrrrrrrrraffffffffffffff
fggggggggggggggggggggggggggggggggggggggggggggggggggggggggggggggggggggggggggggggggggggggggggggggggggggggggggggggggggggggggggggffffgggggggggggggggggggggggfffaaaaaaaaaaaaaaaaffffffffffffff
fggggggggggggggggggggggggggggggggggggggggggggggggggggggggggggggggggggggggggggggggggggggggggggggggggggggggggggggggggggggggggggffffgggggggggggggggggggggggfffffffffffffffffffffffffffffffff
fggggggggggggggggggggggggggggggggggggggggggggggggggggggggggggggggggggggggggggggggggggggggggggggggggggggggggggggggggggggggggggffffffffffffffffffffffffffffffffffffffffffffffffffffffffffff
fggggggggggggggggggggggggggggggggggggggggggggggggggggggggggggggggggggggggggggggggggggggggggggggggggggggggggggggggggggggggggggffffffffffffffffffffffffffffffffffffffffffffffffffffffffffff
fgggggggggggggggggggggggggggggggggggggggggggggggggggggggggggggggggggggggggggggggggggggggggggggggggggggggggggggggggggggggggggggggggggggggggggggggggggggggggggggggggggggggggggggggggggggggg
fgggggggggggggggggggggggggggggggggggggggggggggggggggggggggggggggggggggggggggggggggggggggggggggggggggggggggggggggggggggggggggggggggggggggggggggggggggggggggggggggggggggggggggggggggggggggg
fgggggggggggggggggggggggggggggggggggggggggggggggggggggggggggggggggggggggggggggggggggggggggggggggggggggggggggggggggggggggggggggggggggggggggggggggggggggggggggggggggggggggggggggggggggggggg
fgggggggggggggggggggggggggggggggggggggggggggggggggggggggggggggggggggggggggggggggggggggggggggggggggggggggggggggggggggggggggggggggggggggggggggggggggggggggggggggggggggggggggggggggggggggggg
fgggggggggggggggggggggggggggggggggggggggggggggggggggggggggggggggggggggggggggggggggggggggggggggggggggggggggggggggggggggggggggggggggggggggggggggggggggggggggggggggggggggggggggggggggggggggg
fgggggggggggggggggggggggggggggggggggggggggggggggggggggggggggggggggggggggggggggggggggggggggggggggggggggggggggggggggggggggggggggggggggggggggggggggggggggggggggggggggggggggggggggggggggggggg
fgggggggggggggggggggggggggggggggggggggggggggggggggggggggggggggggggggggggggggggggggggggggggggggggggggggggggggggggggggggggggggggggggggggggggggggggggggggggggggggggggggggggggggggggggggggggg
fgggggggggggggggggggggggggggggggggggggggggggggggggggggggggggggggggggggggggggggggggggggggggggggggggggggggggggggggggggggggggggggggggggggggggggggggggggggggggggggggggggggggggggggggggggggggg
fgggggggggggggggggggggggggggggggggggggggggggggggggggggggggggggggggggggggggggggggggggggggggggggggggggggggggggggggggggggggggggggggggggggggggggggggggggggggggggggggggggggggggggggggggggggggg
fgggggggggggggggggggggggggggggggggggggggggggggggggggggggggggggggggggggggggggggggggggggggggggggggggggggggggggggggggggggggggggggggggggggggggggggggggggggggggggggggggggggggggggggggggggggggg
fgggggggggggggggggggggggggggggggggggggggggggggggggggggggggggggggggggggggggggggggggggggggggggggggggggggggggggggggggggggggggggggggggggggggggggggggggggggggggggggggggggggggggggggggggggggggg
fgggggggggggggggggggggggggggggggggggggggggggggggggggggggggggggggggggggggggggggggggggggggggggggggggggggggggggggggggggggggggggggggggggggggggggggggggggggggggggggggggggggggggggggggggggggggg
fgggggggggggggggggggggggggggggggggggggggggggggggggggggggggggggggggggggggggggggggggggggggggggggggggggggggggggggggggggggggggggggggggggggggggggggggggggggggggggggggggggggggggggggggggggggggg
fgggggggggggggggggggggggggggggggggggggggggggggggggggggggggggggggggggggggggggggggggggggggggggggggggggggggggggggggggggggggggggggggggggggggggggggggggggggggggggggggggggggggggggggggggggggggg
fgggggggggggggggggggggggggggggggggggggggggggggggggggggggggggggggggggggggggggggggggggggggggggggggggggggggggggggggggggggggggggggggggggggggggggggggggggggggggggggggggggggggggggggggggggggggg
fgggggggggggggggggggggggggggggggggggggggggggggggggggggggggggggggggggggggggggggggggggggggggggggggggggggggggggggggggggggggggggggggggggggggggggggggggggggggggggggggggggggggggggggggggggggggg
fgggggggggggggggggggggggggggggggggggggggggggggggggggggggggggggggggggggggggggggggggggggggggggggggggggggggggggggggggggggggggggggggggggggggggggggggggggggggggggggggggggggggggggggggggggggggg
fgggggggggggggggggggggggggggggggggggggggggggggggggggggggggggggggggggggggggggggggggggggggggggggggggggggggggggggggggggggggggggggggggggggggggggggggggggggggggggggggggggggggggggggggggggggggg
fgggggggggggggggggggggggggggggggggggggggggggggggggggggggggggggggggggggggggggggggggggggggggggggggggggggggggggggggggggggggggggggggggggggggggggggggggggggggggggggggggggggggggggggggggggggggg
fgggggggggggggggggggggggggggggggggggggggggggggggggggggggggggggggggggggggggggggggggggggggggggggggggggggggggggggggggggggggggggggggggggggggggggggggggggggggggggggggggggggggggggggggggggggggg
fffffffffffffffffffffffffffffffffffffffffffffffffffffffffffffffffffffffffffffffffffffffffffffffffffffffffffffffffffffffffffffffffffffffffffffffffffffffffffffffffffffffffffffffffffffffff
"}
