"a" = (/turf/closed/wall/mineral/wood,/area/maintenance/polovich/forest/rain)
"b" = (/turf/open/floor/plating/polovich/rockydarkness,/area/maintenance/polovich/forest/rain)
"c" = (/obj/structure/railing{dir = 8},/turf/open/floor/plating/polovich/rockydarkness,/area/maintenance/polovich/forest/rain)
"d" = (/turf/closed/wall/darkrock,/area/maintenance/polovich/forest/rain)
"e" = (/obj/structure/stairs/north,/turf/open/floor/plating/polovich/rockydarkness,/area/maintenance/polovich/forest/rain)
"f" = (/turf/closed/wall/purple/nocling,/area/maintenance/polovich/forest/rain)
"g" = (/turf/open/openspace/norm,/area/maintenance/polovich/forest/rain)
"h" = (/turf/open/floor/plating/polovich/rockedar,/area/maintenance/polovich/forest/rain)
"i" = (/obj/structure/table/reinforced,/turf/open/floor/plating/polovich/rockydarkness,/area/maintenance/polovich/forest/rain)
"j" = (/obj/structure/stairs/south,/turf/open/floor/plating/polovich/rockydarkness,/area/maintenance/polovich/forest/rain)

(1,1,1) = {"
fffffffffffffffffffffffffffffffffffffffffffffffffffffffffffffffffffffffffffffffffffffffffffffffffffffffffffffffffffffffffffffffffffffffffffffffffffffffffffffffffffffffffffffffffffffffff
fgggggggggggggggggggggggggggggggggggggggggggggggggggggggggggggggggggggggggggggggggggggggggggggggggggggggggggggggggggggffgggggggggggggffffffffffffffffffffffffffffffffffffffffffffffffffff
fgggggggggggggggggggggggggggggggggggggggggggggggggggggggggggggggggggggggggggggggggggggggggggggggggggggggggggggggggggggffgggggggggggggffffffffffffffffffffffffffffffffffffffffffffffffffff
fgggggggggggggggggggggggggggggggggggggggggggggggggggggggggggggggggggggggggggggggggggggggggggggggggggggggggggggggggggggffgggggggggggggffffffffffffffffffffffffbbbbbbbbbbbbbbbbbbbbbbbbffff
fgggggggggggggggggggggggggggggggggggggggggggggggggggggggggggggggggggggggggggggggggggggggggggggggggggggggggggggggggggggffgggggggggggggfffaaaaaaaaaaaaaaaaaaabbbddddddddddddddddddddddbffff
fgggggggggggggggggggggggggggggggggggggggggggggggggggggggggggggggggggggggggggggggggggggggggggggggggggggggggggggggggggggffgggggggggggggfffabbbbbabbbbbabbbbbabbbdbbbbdbbbbbbbbdbbddbbdbffff
fgggggggggggggggggggggggggggggggggggggggggggggggggggggggggggggggggggggggggggggggggggggggggggggggggggggggggggggggggggggffgggggggggggggfffabbbbbabbbbbabbbbbabbbdbbbbbbbbbbbbbbbbddbbdbffff
fgggggggggggggggggggggggggggggggggggggggggggggggggggggggggggggggggggggggggggggggggggggggggggggggggggggggggggggggggggggffgggggggggggggfffabbbbbabbbbbabbbbbabbbdbbbbdbbbbbbbbdbbeebbdbffff
fgggggggggggggggggggggggggggggggggggggggggggggggggggggggggggggggggggggggggggggggggggggggggggggggggggggggggggggggggggggffgggggggggggggfffabbbbjabbbbjabbbbjabbbddiidddddddddddbbbbbbdbffff
fgggggggggggggggggggggggggggggggggggggggggggggggggggggggggggggggggggggggggggggggggggggggggggggggggggggggggggggggggggggffgggggggggggggfffabbbbaabbbbaabbbbaabbbdbbbbdbbbbbbbbdbbbbbbdbffff
fgggggggggggggggggggggggggggggggggggggggggggggggggggggggggggggggggggggggggggggggggggggggggggggggggggggggggggggggggggggffgggggggggggggffbabaaaaabaaaaabaaaaabbbdbbbbbbbbbbbbbbbbbbbbdbffff
fgggggggggggggggggggggggggggggggggggggggggggggggggggggggggggggggggggggggggggggggggggggggggggggggggggggggggggggggggggggffgggggggggggggffbbbbbbbbbbbbbbbbbbbbbbbdbbdddbbbbbbbbdbbbbbbdbffff
fgggggggggggggggggggggggggggggggggggggggggggggggggggggggggggggggggggggggggggggggggggggggggggggggggggggggggggggggggggggffggggggggggggggbbbbbbbbbbbbbbbbbbbbbbbbdbbdddddddddddddddddddbffff
fgggggggggggggggggggggggggggggggggggggggggggggggggggggggggggggggggggggggggggggggggggggggggggggggggggggggggggggggggggggffggggggggggggggbbbbbbbbbbbbbbbbbbbbbbbbbbbbbbbbbbbbbbbbbbbbbbbffff
fgggggggggggggggggggggggggggggggggggggggggggggggggggggggggggggggggggggggggggggggggggggggggggggggggggggggggggggggggggggffggggggggggggggbbbbbbbbbbbbbbbbbbbbbbbbbbbbbbbbbbbbbbbbbbbbbbbffff
fgggggggggggggggggggggggggggggggggggggggggggggggggggggggggggggggggggggggggggggggggggggggggggggggggggggggggggggggggggggffgggggggggggggffbbbbffffffffffffffffffffbbbfffffffffffffffffffffff
fgggggggggggggggggggggggggggggggggggggggggggggggggggggggggggggggggggggggggggggggggggggggggggggggggggggggggggggggggggggffgggggggggggggffbbbbffffffffffffffffffffbbbfffffffffffffffffffffff
fgggggggggggggggggggggggggggggggggggggggggggggggggggggggggggggggggggggggggggggggggggggggggggggggggggggggggggggggggggggffgggggggggggggffbbbbffggggggggggggggggffbbbfffffffffffffffffffffff
fgggggggggggggggggggggggggggggggggggggggggggggggggggggggggggggggggggggggggggggggggggggggggggggggggggggggggggggggggggggffgggggggggggggffbbbbffggggggggggggggggffbbbfffffffffffffffffffffff
fgggggggggggggggggggggggggggggggggggggggggggggggggggggggggggggggggggggggggggggggggggggggggggggggggggggggggggggggggggggffgggggggggggggffbbbbffggggggggggggggggffbbbfffffffffffffffffffffff
fgggggggggggggggggggggggggggggggggggggggggggggggggggggggggggggggggggggggggggggggggggggggggggggggggggggggggggggggggggggffgggggggggggggffbbbbffggggggggggggggggffbbbfffffffffffffffffffffff
fgggggggggggggggggggggggggggggggggggggggggggggggggggggggggggggggggggggggggggggggggggggggggggggggggggggggggggggggggggggffgggggggggggggffbbbbffggggggggggggggggbbbbbfffffffffffffffffffffff
fgggggggggggggggggggggggggggggggggggggggggggggggggggggggggggggggggggggggggggggggggggggggggggggggggggggggggggggggggggggffgggggggggggggffbbbbffggggggggggggggggbbbbbfffffffffffffffffffffff
fgggggggggggggggggggggggggggggggggggggggggggggggggggggggggggggggggggggggggggggggggggggggggggggggggggggggggggggggggggggffgggggggggggggffbbbbffggggggggggggggggbbbbbfffffffffffffffffffffff
fgggggggggggggggggggggggggggggggggggggggggggggggggggggggggggggggggggggggggggggggggggggggggggggggggggggggggggggggggggggffgggggggggggggffbbbbffggggggggggggggggffbbbfffffffffffffffffffffff
fgggggggggggggggggggggggggggggggggggggggggggggggggggggggggggggggggggggggggggggggggggggggggggggggggggggggggggggggggggggffffffffffffgggffbbbbffggggggggggggggggffbbbfffffffffffffffffffffff
fggggggggggggggggggggggggggggggggggggggggggggggggggggggggggggggggggggggggggggggggggggggggggggggggggggggggggggggggggggggffffffffffffggffbbbbffggggggggggggggggffbbbfffffffffffffffffffffff
fggggggggggggggggggggggggggggggggggggggggggggggggggggggggggggggggggggggggggggggggggggggggggggggggggggggggggggggggggggggggggggcbbbffffffbbbbffggggggggggggggggffffffffffffffffffffffffffff
fggggggggggggggggggggggggggggggggggggggggggggggggggggggggggggggggggggggggggggggggggggggggggggggggggggggggggggggggggggggggggggcbbbbfffffbbbbffggggggggggggggggffffffffffffffffffffffffffff
fggggggggggggggggggggggggggggggggggggggggggggggggggggggggggggggggggggggggggggggggggggggggggggggggggggggggggggggggggggggggggggbbbbbbbbbbbbbbffggggggggggggggggffffffffffffffffffffffffffff
fggggggggggggggggggggggggggggggggggggggggggggggggggggggggggggggggggggggggggggggggggggggggggggggggggggggggggggggggggggggggggggbbbbbbbbbbbbbbffggggggggggggggggffffffffffffffffffffffffffff
fggggggggggggggggggggggggggggggggggggggggggggggggggggggggggggggggggggggggggggggggggggggggggggggggggggggggggggggggggggggggggggbbbbbbbbbbbbbbffggggggggggggggggffffffffffffffffffffffffffff
fggggggggggggggggggggggggggggggggggggggggggggggggggggggggggggggggggggggggggggggggggggggggggggggggggggggggggggggggggggggggggggbbbbbbbbbbbbbbffggggggggggggggggffffffffffffffffffffffffffff
fggggggggggggggggggggggggggggggggggggggggggggggggggggggggggggggggggggggggggggggggggggggggggggggggggggggggggggggggggggggggggggcbbbbfffffbbbbffggggggggggggggggffffffffffffffffffffffffffff
fggggggggggggggggggggggggggggggggggggggggggggggggggggggggggggggggggggggggggggggggggggggggggggggggggggggggggggggggggggggggggggcbbbbfffffbbbbffggggggggggggggggffffffffffffffffffffffffffff
fggggggggggggggggggggggggggggggggggggggggggggggggggggggggggggggggggggggggggggggggggggggggggggggggggggggggggggggggggggggggggggcbbbbfffffbbbbffggggggggggggggggffffffffffffffffffffffffffff
fggggggggggggggggggggggggggggggggggggggggggggggggggggggggggggggggggggggggggggggggggggggggggggggggggggggggggggggggggggggggggggfbbfffffffbbbbffggggggggggggggggffffffffffffffffffffffffffff
fggggggggggggggggggggggggggggggggggggggggggggggggggggggggggggggggggggggggggggggggggggggggggggggggggggggggggggggggggggggggggggfbbfffffffbbbbffggggggggggggggggffffffffffffffffffffffffffff
fggggggggggggggggggggggggggggggggggggggggggggggggggggggggggggggggggggggggggggggggggggggggggggggggggggggggggggggggggggggggggggfbbfffffffbbbbffggggggggggggggggffffffffffffffffffffffffffff
fggggggggggggggggggggggggggggggggggggggggggggggggggggggggggggggggggggggggggggggggggggggggggggggggggggggggggggggggggggggggggggfbbfffffbbbbbbffggggggggggggggggffffffffffffffffffffffffffff
fggggggggggggggggggggggggggggggggggggggggggggggggggggggggggggggggggggggggggggggggggggggggggggggggggggggggggggggggggggggggggggffffffffbbbbbbffggggggggggggggggffffffffffffffffffffffffffff
fggggggggggggggggggggggggggggggggggggggggggggggggggggggggggggggggggggggggggggggggggggggggggggggggggggggggggggggggggggggggggggffffffffbbbbbbffggggggggggggggggffffffffffffffffffffffffffff
fggggggggggggggggggggggggggggggggggggggggggggggggggggggggggggggggggggggggggggggggggggggggggggggggggggggggggggggggggggggggggggfffffffffbbbbbffggggggggggggggggffffffffffffffffffffffffffff
fggggggggggggggggggggggggggggggggggggggggggggggggggggggggggggggggggggggggggggggggggggggggggggggggggggggggggggggggggggggggggggfffffffffbbbbbffggggggggggggggggffffffffffffffffffffffffffff
fggggggggggggggggggggggggggggggggggggggggggggggggggggggggggggggggggggggggggggggggggggggggggggggggggggggggggggggggggggggggggggaaaaaaaaabbbbbffggggggggggggggggffffffffffffffffffffffffffff
fggggggggggggggggggggggggggggggggggggggggggggggggggggggggggggggggggggggggggggggggggggggggggggggggggggggggggggggggggggggggggggabbbabbbabbbbbffggggggggggggggggffffffffffffffffffffffffffff
fggggggggggggggggggggggggggggggggggggggggggggggggggggggggggggggggggggggggggggggggggggggggggggggggggggggggggggggggggggggggggggabbbabbbabbbbbffggggggggggggggggffffffffffffffffffffffffffff
fggggggggggggggggggggggggggggggggggggggggggggggggggggggggggggggggggggggggggggggggggggggggggggggggggggggggggggggggggggggggggggabbbabbbabbbbbffggggggggggggggggffffffffffffffffffffffffffff
fggggggggggggggggggggggggggggggggggggggggggggggggggggggggggggggggggggggggggggggggggggggggggggggggggggggggggggggggggggggggggggabbbibbbbbbbbbffggggggggggggggggffffffffffffffffffffffffffff
fggggggggggggggggggggggggggggggggggggggggggggggggggggggggggggggggggggggggggggggggggggggggggggggggggggggggggggggggggggggggggggabbbibbbbbbbbbffggggggggggggggggffffffffffffffffffffffffffff
fggggggggggggggggggggggggggggggggggggggggggggggggggggggggggggggggggggggggggggggggggggggggggggggggggggggggggggggggggggggggggggabbbabbbbbbbbbffggggggggggggggggffffffffffffffffffffffffffff
fggggggggggggggggggggggggggggggggggggggggggggggggggggggggggggggggggggggggggggggggggggggggggggggggggggggggggggggggggggggggggggabbbbbbbabbbbbffggggggggggggggggffffffffffffffffffffffffffff
fggggggggggggggggggggggggggggggggggggggggggggggggggggggggggggggggggggggggggggggggggggggggggggggggggggggggggggggggggggggggggggabbaaaaaabbbbbffggggggggggggggggffffffffffffffffffffffffffff
fggggggggggggggggggggggggggggggggggggggggggggggggggggggggggggggggggggggggggggggggggggggggggggggggggggggggggggggggggggggggggggabbbbbbbabbbbbffggggggggggggggggffffffffffffffffffffffffffff
fggggggggggggggggggggggggggggggggggggggggggggggggggggggggggggggggggggggggggggggggggggggggggggggggggggggggggggggggggggggggggggabbbbbbbabbbbbffggggggggggggggggffffffffffffffffffffffffffff
fggggggggggggggggggggggggggggggggggggggggggggggggggggggggggggggggggggggggggggggggggggggggggggggggggggggggggggggggggggggggggggabbbbbbbabbbbbffggggggggggggggggffffffffffffffffffffffffffff
fggggggggggggggggggggggggggggggggggggggggggggggggggggggggggggggggggggggggggggggggggggggggggggggggggggggggggggggggggggggggggggabbaaaaaabbbbbffggggggggggggggggffffffffffffffffffffffffffff
fggggggggggggggggggggggggggggggggggggggggggggggggggggggggggggggggggggggggggggggggggggggggggggggggggggggggggggggggggggggggggggabbbbbbbabbbbbffggggggggggggggggffffffffffffffffffffffffffff
fggggggggggggggggggggggggggggggggggggggggggggggggggggggggggggggggggggggggggggggggggggggggggggggggggggggggggggggggggggggggggggabbbbbbbabbbbbffgggggggggggggggggfffffffffffffffffffffffffff
fggggggggggggggggggggggggggggggggggggggggggggggggggggggggggggggggggggggggggggggggggggggggggggggggggggggggggggggggggggggggggggabbbbbbbabbbbbffgggggggggggggggggfffffffffffffffffffffffffff
fggggggggggggggggggggggggggggggggggggggggggggggggggggggggggggggggggggggggggggggggggggggggggggggggggggggggggggggggggggggggggggaaaaaaaaabbbbbffgggggggggggggggggfffffffffffffffffffffffffff
fggggggggggggggggggggggggggggggggggggggggggggggggggggggggggggggggggggggggggggggggggggggggggggggggggggggggggggggggggggggggggggfbbbggbbbbbbbbffgggggggggggggggggfffffffffffffffffffffffffff
fggggggggggggggggggggggggggggggggggggggggggggggggggggggggggggggggggggggggggggggggggggggggggggggggggggggggggggggggggggggggggggfbbbggbbbbbbbbffgggggggggggggggggfffffffffffffffffffffffffff
fggggggggggggggggggggggggggggggggggggggggggggggggggggggggggggggggggggggggggggggggggggggggggggggggggggggggggggggggggggggggggggfbbbggbbbbbbbbffgggggggggggggggggfffffffffffffffffffffffffff
fggggggggggggggggggggggggggggggggggggggggggggggggggggggggggggggggggggggggggggggggggggggggggggggggggggggggggggggggggggggggggggfbbbggbbbbbbbbffggggggggggggggggggggffffffffffffffffffffffff
fggggggggggggggggggggggggggggggggggggggggggggggggggggggggggggggggggggggggggggggggggggggggggggggggggggggggggggggggggggggggggggfbbbggbbbbbbbbffggggggggggggggggggggffbbbbbfffffffffffffffff
fggggggggggggggggggggggggggggggggggggggggggggggggggggggggggggggggggggggggggggggggggggggggggggggggggggggggggggggggggggggggggggfbbbhhbbbbbbbbffggggggggggggggggggggffbbbbbfffffffffffffffff
fggggggggggggggggggggggggggggggggggggggggggggggggggggggggggggggggggggggggggggggggggggggggggggggggggggggggggggggggggggggggggggfbbbhhbbbbbbbbffggggggggggggggggggggffbbbbbfffffffffffffffff
fggggggggggggggggggggggggggggggggggggggggggggggggggggggggggggggggggggggggggggggggggggggggggggggggggggggggggggggggggggggggggggfbbbhhbbbbbbbbffffffffffffffffffffffffbbbbbfffffffffffffffff
fggggggggggggggggggggggggggggggggggggggggggggggggggggggggggggggggggggggggggggggggggggggggggggggggggggggggggggggggggggggggggggfbbbggbbbbbbbbffffffffffffffffffffffffbbbbbfffffffffffffffff
fggggggggggggggggggggggggggggggggggggggggggggggggggggggggggggggggggggggggggggggggggggggggggggggggggggggggggggggggggggggggggggfbbbggbbbbbbbbbbbbbbbbbbbbbbbbbbbbbbbbbbbbbbbbbbbbbbbbbbbfff
fggggggggggggggggggggggggggggggggggggggggggggggggggggggggggggggggggggggggggggggggggggggggggggggggggggggggggggggggggggggggggggfbbbggbbbbbbbbbbbbbbbbbbbbbbbbbbbbbbbbbbbbbbbbbbbbbbbbbbbfff
fggggggggggggggggggggggggggggggggggggggggggggggggggggggggggggggggggggggggggggggggggggggggggggggggggggggggggggggggggggggggggggfffffffffffbbbbbbbbbbbbbbbbbbbbbbbbbbbbbbbbbbbbbbbbbbbbbbfff
fggggggggggggggggggggggggggggggggggggggggggggggggggggggggggggggggggggggggggggggggggggggggggggggggggggggggggggggggggggggggggggfffffffffffbbbbbbbbbbbbbbbbbbbbbbbbbbbbbbbbbbbbbbbbbbbbbbfff
fggggggggggggggggggggggggggggggggggggggggggggggggggggggggggggggggggggggggggggggggggggggggggggggggggggggggggggggggggggggggggggfffffffffffbbbbbbbbbbbbbbbbbbbbbbbbbbbbbbbbbbbbbbbbbbbbbbfff
fggggggggggggggggggggggggggggggggggggggggggggggggggggggggggggggggggggggggggggggggggggggggggggggggggggggggggggggggggggggggggggfffffffffffbbbffbbbbffbbbbbbbbbbbbbbffbbbbbfffffbbbbbbbbbfff
fggggggggggggggggggggggggggggggggggggggggggggggggggggggggggggggggggggggggggggggggggggggggggggggggggggggggggggggggggggggggggggfffffffffffbbbffbbbbffbbbbbbbbbbbbbbffbbbbbfffffbbbbbbbbbfff
fggggggggggggggggggggggggggggggggggggggggggggggggggggggggggggggggggggggggggggggggggggggggggggggggggggggggggggggggggggggggggggfffffffffffbbbffggggffbbbffffbbbbbbbffbbbbbfffffbbbbbbbbbfff
fggggggggggggggggggggggggggggggggggggggggggggggggggggggggggggggggggggggggggggggggggggggggggggggggggggggggggggggggggggggggggggffffffffffffffffggggfffffffffbbbbbbbffbbbbbfffffbbbbbbbbbfff
fggggggggggggggggggggggggggggggggggggggggggggggggggggggggggggggggggggggggggggggggggggggggggggggggggggggggggggggggggggggggggggffffffffffffffffggggffffffffbbbbbbbbffbbbbbfffffbbbbbbbbbfff
fggggggggggggggggggggggggggggggggggggggggggggggggggggggggggggggggggggggggggggggggggggggggggggggggggggggggggggggggggggggggggggffffgggggggggggggggggggggggfbbbbbbbbffbbbbbfffffffffffffffff
fggggggggggggggggggggggggggggggggggggggggggggggggggggggggggggggggggggggggggggggggggggggggggggggggggggggggggggggggggggggggggggffffgggggggggggggggggggggggffbbbbbbfffbbbbbfffffffffffffffff
fggggggggggggggggggggggggggggggggggggggggggggggggggggggggggggggggggggggggggggggggggggggggggggggggggggggggggggggggggggggggggggffffgggggggggggggggggggggggfffffffffffbbbbbfffffffffffffffff
fggggggggggggggggggggggggggggggggggggggggggggggggggggggggggggggggggggggggggggggggggggggggggggggggggggggggggggggggggggggggggggffffgggggggggggggggggggggggfffffffffffbbbbbfffffffffffffffff
fggggggggggggggggggggggggggggggggggggggggggggggggggggggggggggggggggggggggggggggggggggggggggggggggggggggggggggggggggggggggggggffffgggggggggggggggggggggggfffffffffffbbbbbfffffffffffffffff
fggggggggggggggggggggggggggggggggggggggggggggggggggggggggggggggggggggggggggggggggggggggggggggggggggggggggggggggggggggggggggggffffgggggggggggggggggggggggfffffffffffbbbbbfffffffffffffffff
fggggggggggggggggggggggggggggggggggggggggggggggggggggggggggggggggggggggggggggggggggggggggggggggggggggggggggggggggggggggggggggffffgggggggggggggggggggggggfffffffffffbbbbbfffffffffffffffff
fggggggggggggggggggggggggggggggggggggggggggggggggggggggggggggggggggggggggggggggggggggggggggggggggggggggggggggggggggggggggggggffffgggggggggggggggggggggggfffffffffffbbbbbfffffffffffffffff
fggggggggggggggggggggggggggggggggggggggggggggggggggggggggggggggggggggggggggggggggggggggggggggggggggggggggggggggggggggggggggggffffgggggggggggggggggggggggfffffffffffbbbbbfffffffffffffffff
fggggggggggggggggggggggggggggggggggggggggggggggggggggggggggggggggggggggggggggggggggggggggggggggggggggggggggggggggggggggggggggffffgggggggggggggggggggggggffffffbbbbbbbbbbbbbbbbbbfffffffff
fggggggggggggggggggggggggggggggggggggggggggggggggggggggggggggggggggggggggggggggggggggggggggggggggggggggggggggggggggggggggggggffffgggggggggggggggggggggggffffffbbbbbbbbbbbbbbbbbbfffffffff
fggggggggggggggggggggggggggggggggggggggggggggggggggggggggggggggggggggggggggggggggggggggggggggggggggggggggggggggggggggggggggggffffgggggggggggggggggggggggffffffbbbbbbbabaaaaaaaaafffffffff
fggggggggggggggggggggggggggggggggggggggggggggggggggggggggggggggggggggggggggggggggggggggggggggggggggggggggggggggggggggggggggggffffgggggggggggggggggggggggfffffbbbbbbbbabbbbbbbbbafffffffff
fggggggggggggggggggggggggggggggggggggggggggggggggggggggggggggggggggggggggggggggggggggggggggggggggggggggggggggggggggggggggggggffffgggggggggggggggggggggggggbbbbbbbbbbbabbbbbbbbbafffffffff
fggggggggggggggggggggggggggggggggggggggggggggggggggggggggggggggggggggggggggggggggggggggggggggggggggggggggggggggggggggggggggggffffgggggggggggggggggggggggggbbbbbbbbbbbabbbbbbbbbafffffffff
fggggggggggggggggggggggggggggggggggggggggggggggggggggggggggggggggggggggggggggggggggggggggggggggggggggggggggggggggggggggggggggffffgggggggggggggggggggggggffbbbbbbbbbbbabbbbaaaaaafffffffff
fggggggggggggggggggggggggggggggggggggggggggggggggggggggggggggggggggggggggggggggggggggggggggggggggggggggggggggggggggggggggggggffffgggggggggggggggggggggggfffaaaaaaaaaaabbbbabfffffffffffff
fggggggggggggggggggggggggggggggggggggggggggggggggggggggggggggggggggggggggggggggggggggggggggggggggggggggggggggggggggggggggggggffffgggggggggggggggggggggggfffabbbbbabbbbbbbbabfffffffffffff
fggggggggggggggggggggggggggggggggggggggggggggggggggggggggggggggggggggggggggggggggggggggggggggggggggggggggggggggggggggggggggggffffgggggggggggggggggggggggfffabbbbbabbbbbbbbbbfffffffffffff
fggggggggggggggggggggggggggggggggggggggggggggggggggggggggggggggggggggggggggggggggggggggggggggggggggggggggggggggggggggggggggggffffgggggggggggggggggggggggfffabbbbbbbbbbbbbbaffffffffffffff
fggggggggggggggggggggggggggggggggggggggggggggggggggggggggggggggggggggggggggggggggggggggggggggggggggggggggggggggggggggggggggggffffgggggggggggggggggggggggfffaaaaaaaaaaaaaaaaffffffffffffff
fggggggggggggggggggggggggggggggggggggggggggggggggggggggggggggggggggggggggggggggggggggggggggggggggggggggggggggggggggggggggggggffffgggggggggggggggggggggggfffffffffffffffffffffffffffffffff
fggggggggggggggggggggggggggggggggggggggggggggggggggggggggggggggggggggggggggggggggggggggggggggggggggggggggggggggggggggggggggggffffffffffffffffffffffffffffffffffffffffffffffffffffffffffff
fggggggggggggggggggggggggggggggggggggggggggggggggggggggggggggggggggggggggggggggggggggggggggggggggggggggggggggggggggggggggggggffffffffffffffffffffffffffffffffffffffffffffffffffffffffffff
fgggggggggggggggggggggggggggggggggggggggggggggggggggggggggggggggggggggggggggggggggggggggggggggggggggggggggggggggggggggggggggggggggggggggggggggggggggggggggggggggggggggggggggggggggggggggg
fgggggggggggggggggggggggggggggggggggggggggggggggggggggggggggggggggggggggggggggggggggggggggggggggggggggggggggggggggggggggggggggggggggggggggggggggggggggggggggggggggggggggggggggggggggggggg
fgggggggggggggggggggggggggggggggggggggggggggggggggggggggggggggggggggggggggggggggggggggggggggggggggggggggggggggggggggggggggggggggggggggggggggggggggggggggggggggggggggggggggggggggggggggggg
fgggggggggggggggggggggggggggggggggggggggggggggggggggggggggggggggggggggggggggggggggggggggggggggggggggggggggggggggggggggggggggggggggggggggggggggggggggggggggggggggggggggggggggggggggggggggg
fgggggggggggggggggggggggggggggggggggggggggggggggggggggggggggggggggggggggggggggggggggggggggggggggggggggggggggggggggggggggggggggggggggggggggggggggggggggggggggggggggggggggggggggggggggggggg
fgggggggggggggggggggggggggggggggggggggggggggggggggggggggggggggggggggggggggggggggggggggggggggggggggggggggggggggggggggggggggggggggggggggggggggggggggggggggggggggggggggggggggggggggggggggggg
fgggggggggggggggggggggggggggggggggggggggggggggggggggggggggggggggggggggggggggggggggggggggggggggggggggggggggggggggggggggggggggggggggggggggggggggggggggggggggggggggggggggggggggggggggggggggg
fgggggggggggggggggggggggggggggggggggggggggggggggggggggggggggggggggggggggggggggggggggggggggggggggggggggggggggggggggggggggggggggggggggggggggggggggggggggggggggggggggggggggggggggggggggggggg
fgggggggggggggggggggggggggggggggggggggggggggggggggggggggggggggggggggggggggggggggggggggggggggggggggggggggggggggggggggggggggggggggggggggggggggggggggggggggggggggggggggggggggggggggggggggggg
fgggggggggggggggggggggggggggggggggggggggggggggggggggggggggggggggggggggggggggggggggggggggggggggggggggggggggggggggggggggggggggggggggggggggggggggggggggggggggggggggggggggggggggggggggggggggg
fgggggggggggggggggggggggggggggggggggggggggggggggggggggggggggggggggggggggggggggggggggggggggggggggggggggggggggggggggggggggggggggggggggggggggggggggggggggggggggggggggggggggggggggggggggggggg
fgggggggggggggggggggggggggggggggggggggggggggggggggggggggggggggggggggggggggggggggggggggggggggggggggggggggggggggggggggggggggggggggggggggggggggggggggggggggggggggggggggggggggggggggggggggggg
fgggggggggggggggggggggggggggggggggggggggggggggggggggggggggggggggggggggggggggggggggggggggggggggggggggggggggggggggggggggggggggggggggggggggggggggggggggggggggggggggggggggggggggggggggggggggg
fgggggggggggggggggggggggggggggggggggggggggggggggggggggggggggggggggggggggggggggggggggggggggggggggggggggggggggggggggggggggggggggggggggggggggggggggggggggggggggggggggggggggggggggggggggggggg
fgggggggggggggggggggggggggggggggggggggggggggggggggggggggggggggggggggggggggggggggggggggggggggggggggggggggggggggggggggggggggggggggggggggggggggggggggggggggggggggggggggggggggggggggggggggggg
fgggggggggggggggggggggggggggggggggggggggggggggggggggggggggggggggggggggggggggggggggggggggggggggggggggggggggggggggggggggggggggggggggggggggggggggggggggggggggggggggggggggggggggggggggggggggg
fgggggggggggggggggggggggggggggggggggggggggggggggggggggggggggggggggggggggggggggggggggggggggggggggggggggggggggggggggggggggggggggggggggggggggggggggggggggggggggggggggggggggggggggggggggggggg
fgggggggggggggggggggggggggggggggggggggggggggggggggggggggggggggggggggggggggggggggggggggggggggggggggggggggggggggggggggggggggggggggggggggggggggggggggggggggggggggggggggggggggggggggggggggggg
fgggggggggggggggggggggggggggggggggggggggggggggggggggggggggggggggggggggggggggggggggggggggggggggggggggggggggggggggggggggggggggggggggggggggggggggggggggggggggggggggggggggggggggggggggggggggg
fgggggggggggggggggggggggggggggggggggggggggggggggggggggggggggggggggggggggggggggggggggggggggggggggggggggggggggggggggggggggggggggggggggggggggggggggggggggggggggggggggggggggggggggggggggggggg
fffffffffffffffffffffffffffffffffffffffffffffffffffffffffffffffffffffffffffffffffffffffffffffffffffffffffffffffffffffffffffffffffffffffffffffffffffffffffffffffffffffffffffffffffffffffff
"}
