"a" = (/turf/closed/wall/mineral/wood,/area/maintenance/polovich/forest/rain)
"b" = (/turf/open/floor/plating/polovich/rockydarkness,/area/maintenance/polovich/forest/rain)
"c" = (/obj/structure/railing{dir = 8},/turf/open/floor/plating/polovich/rockydarkness,/area/maintenance/polovich/forest/rain)
"d" = (/turf/closed/wall/darkrock,/area/maintenance/polovich/forest/rain)
"e" = (/obj/structure/stairs/north,/turf/open/floor/plating/polovich/rockydarkness,/area/maintenance/polovich/forest/rain)
"f" = (/turf/closed/wall/purple/nocling,/area/maintenance/polovich/forest/rain)
"g" = (/turf/open/openspace/norm,/area/maintenance/polovich/forest/rain)
"h" = (/turf/open/floor/plating/polovich/rockedar,/area/maintenance/polovich/forest/rain)
"i" = (/obj/structure/table/reinforced,/turf/open/floor/plating/polovich/rockydarkness,/area/maintenance/polovich/forest/rain)
"j" = (/turf/closed/wall/r_wall/alt/nocling,/area/maintenance/polovich/forest/rain)
"k" = (/turf/open/floor/plating/polovich/logsgreen,/area/maintenance/polovich/forest/rain)
"l" = (/obj/structure/stairs/south,/turf/open/floor/plating/polovich/logsgreen,/area/maintenance/polovich/forest/rain)
"m" = (/turf/closed/wall/r_wall/rusty/nocling,/area/maintenance/polovich/forest/rain)
"n" = (/turf/open/floor/plating/polovich/yelloww,/area/maintenance/polovich/forest/rain)
"o" = (/turf/open/floor/plating/polovich/typaya,/area/maintenance/polovich/forest/rain)
"p" = (/turf/open/floor/plating/polovich/greenstone,/area/maintenance/polovich/forest/rain)
"q" = (/obj/structure/ladder{down = 1},/turf/open/floor/plating/polovich/rockydarkness,/area/maintenance/polovich/forest/rain)
"r" = (/obj/structure/fermenting_barrel/water,/turf/open/floor/plating/polovich/rockydarkness,/area/maintenance/polovich/forest/rain)
"s" = (/obj/structure/fermenting_barrel/water,/turf/open/floor/plating/polovich/logsgreen,/area/maintenance/polovich/forest/rain)

(1,1,1) = {"
fffffffffffffffffffffffffffffffffffffffffffffffffffffffffffffffffffffffffffffffffffffffffffffffffffffffffffffffffffffffffffffffffffffffffffffffffffffffffffffffffffffffffffffffffffffffff
fgggggggggggggggggggggggggggggggggggggggggggggggggggggggggggggggggggggggggggggggggggggggggggggggggggggggggggggggggggggffgggggggggggggffffffffffffffffffffffffffffffffffffffffffffffffffff
fgggggggggggggggggggggggggggggggggggggggggggggggggggggggggggggggggggggggggggggggggggggggggggggggggggggggggggggggggggggffgggggggggggggffffffffffffffffffffffffffffffffffffffffffffffffffff
fgggggggggggggggggggggggggggggggggggggggggggggggggggggggggggggggggggggggggggggggggggggggggggggggggggggggggggggggggggggffgggggggggggggffbbbbbbbbbbbbbbbbbbbbbbbbbbbbbbbbbbbbbbbbbbbbbbffff
fgggggggggggggggggggggggggggggggggggggggggggggggggggggggggggggggggggggggggggggggggggggggggggggggggggggggggggggggggggggffgggggggggggggffbaaaaaaaaaaaaaaaaaaabbbddddddddddddddddddddddbffff
fgggggggggggggggggggggggggggggggggggggggggggggggggggggggggggggggggggggggggggggggggggggggggggggggggggggggggggggggggggggffgggggggggggggffbakkkksakkkksakkkksabbbdbbbbdbbbbbbbbdbbddbbdbffff
fgggggggggggggggggggggggggggggggggggggggggggggggggggggggggggggggggggggggggggggggggggggggggggggggggggggggggggggggggggggffgggggggggggggffbakkkkkakkkkkakkkkkabbbdbbbbbbbbbbbbbbbbddbbdbffff
fgggggggggggggggggggggggggggggggggggggggggggggggggggggggggggggggggggggggggggggggggggggggggggggggggggggggggggggggggggggffgggggggggggggffbakkkkkakkkkkakkkkkabbbdbbbbdbbbbbbbbdbbeebbdbffff
fgggggggggggggggggggggggggggggggggggggggggggggggggggggggggggggggggggggggggggggggggggggggggggggggggggggggggggggggggggggffgggggggggggggffbakkkklakkkklakkkklabbbddiidddddddddddbbbbbbdbffff
fgggggggggggggggggggggggggggggggggggggggggggggggggggggggggggggggggggggggggggggggggggggggggggggggggggggggggggggggggggggffgggggggggggggffbakkkkaakkkkaakkkkaabbbdbbbbdbbbbbbbbdbbbbbbdbffff
fgggggggggggggggggggggggggggggggggggggggggggggggggggggggggggggggggggggggggggggggggggggggggggggggggggggggggggggggggggggffgggggggggggggffbakaaaaakaaaaakaaaaabbbdbbbbbbbbbbbbbbbbbbbbdbffff
fgggggggggggggggggggggggggggggggggggggggggggggggggggggggggggggggggggggggggggggggggggggggggggggggggggggggggggggggggggggffgggggggggggggffbbbbbbbbbbbbbbbbbbbbbbbdbbdddbbbbbbbbdbbbbbbdbffff
fgggggggggggggggggggggggggggggggggggggggggggggggggggggggggggggggggggggggggggggggggggggggggggggggggggggggggggggggggggggffggggggggggggggbbbbbbbbbbbbbbbbbbbbbbbbdbbdddddddddddddddddddbffff
fgggggggggggggggggggggggggggggggggggggggggggggggggggggggggggggggggggggggggggggggggggggggggggggggggggggggggggggggggggggffggggggggggggggbbbbbbbbbbbbbbbbbbbbbbbbbbbbbbbbbbbbbbbbbbbbbbbffff
fgggggggggggggggggggggggggggggggggggggggggggggggggggggggggggggggggggggggggggggggggggggggggggggggggggggggggggggggggggggffggggggggggggggbbbbbbbbbbbbbbbbbbbbbbbbbbbbbbbbbbbbbbbbbbbbbbbffff
fgggggggggggggggggggggggggggggggggggggggggggggggggggggggggggggggggggggggggggggggggggggggggggggggggggggggggggggggggggggffgggggggggggggffbbbbffffffffffffffffffffbbbbbbbbbbbbbbbbbbbbbbffff
fgggggggggggggggggggggggggggggggggggggggggggggggggggggggggggggggggggggggggggggggggggggggggggggggggggggggggggggggggggggffgggggggggggggffbbbbffffffffffffffffffffbbbfffffffffffffffffffffff
fgggggggggggggggggggggggggggggggggggggggggggggggggggggggggggggggggggggggggggggggggggggggggggggggggggggggggggggggggggggffgggggggggggggffbbbbffggggggggggggggggffbbbfffffffffffffffffffffff
fgggggggggggggggggggggggggggggggggggggggggggggggggggggggggggggggggggggggggggggggggggggggggggggggggggggggggggggggggggggffgggggggggggggffbbbbffggggggggggggggggffbbbfffffffffffffffffffffff
fgggggggggggggggggggggggggggggggggggggggggggggggggggggggggggggggggggggggggggggggggggggggggggggggggggggggggggggggggggggffgggggggggggggffbbbbffggggggggggggggggffbbbfffffffffffffffffffffff
fgggggggggggggggggggggggggggggggggggggggggggggggggggggggggggggggggggggggggggggggggggggggggggggggggggggggggggggggggggggffgggggggggggggffbbbbffggggggggggggggggffbbbfffffffffffffffffffffff
fgggggggggggggggggggggggggggggggggggggggggggggggggggggggggggggggggggggggggggggggggggggggggggggggggggggggggggggggggggggffgggggggggggggffbbbbffggggggggggggggggbbbbbfffffffffffffffffffffff
fgggggggggggggggggggggggggggggggggggggggggggggggggggggggggggggggggggggggggggggggggggggggggggggggggggggggggggggggggggggffgggggggggggggffbbbbffggggggggggggggggbbbbbfffffffffffffffffffffff
fgggggggggggggggggggggggggggggggggggggggggggggggggggggggggggggggggggggggggggggggggggggggggggggggggggggggggggggggggggggffgggggggggggggffbbbbffggggggggggggggggbbbbbfffffffffffffffffffffff
fgggggggggggggggggggggggggggggggggggggggggggggggggggggggggggggggggggggggggggggggggggggggggggggggggggggggggggggggggggggffgggggggggggggffbbbbffggggggggggggggggmmbbbmmfffffffffffffffffffff
fgggggggggggggggggggggggggggggggggggggggggggggggggggggggggggggggggggggggggggggggggggggggggggggggggggggggggggggggggggggffffffffffffgggffbbbbffggggggggggggggggmmbbbmmfffffffffffffffffffff
fggggggggggggggggggggggggggggggggggggggggggggggggggggggggggggggggggggggggggggggggggggggggggggggggggggggggggggggggggggggffffffffffffggffbbbbffggggggggggggggggmmbbbmmjjjjjjjjjjjjjjjjjjjjf
fggggggggggggggggggggggggggggggggggggggggggggggggggggggggggggggggggggggggggggggggggggggggggggggggggggggggggggggggggggggggggggcbbbffffffbbbbffggggggggggggggggmkkkkkkjjjjjkkkkkkkkkjjjjjjf
fggggggggggggggggggggggggggggggggggggggggggggggggggggggggggggggggggggggggggggggggggggggggggggggggggggggggggggggggggggggggggggcbbbbfffffbbbbffggggggggggggggggkkkkkkkjjjjjkkkkkkkkkjjjjjjf
fggggggggggggggggggggggggggggggggggggggggggggggggggggggggggggggggggggggggggggggggggggggggggggggggggggggggggggggggggggggggggggbbbbbbbbbbbbbbffggggggggggggggggmkkkkkkkkkkkkkkkkkkkkkkkkkjf
fggggggggggggggggggggggggggggggggggggggggggggggggggggggggggggggggggggggggggggggggggggggggggggggggggggggggggggggggggggggggggggbbbbbbbbbbbbbbffggggggggggggggggkkkkkkkkkkkkkkkkkkkkkkkkkkjf
fggggggggggggggggggggggggggggggggggggggggggggggggggggggggggggggggggggggggggggggggggggggggggggggggggggggggggggggggggggggggggggbbbbbbbbbbbbbbffggggggggggggggggmkkkkkkjjjjjkkkkkkkkkjjjkkjf
fggggggggggggggggggggggggggggggggggggggggggggggggggggggggggggggggggggggggggggggggggggggggggggggggggggggggggggggggggggggggggggbbbbbbbbbbbbbbffggggggggggggggggkkkkkkkjjjjjkkkkkkkkkjjjkkjf
fggggggggggggggggggggggggggggggggggggggggggggggggggggggggggggggggggggggggggggggggggggggggggggggggggggggggggggggggggggggggggggcbbbbfffffbbbbffggggggggggggggggmjkkjjjjjjjjkkkkkkkkkjjjkkjf
fggggggggggggggggggggggggggggggggggggggggggggggggggggggggggggggggggggggggggggggggggggggggggggggggggggggggggggggggggggggggggggcbbbbfffffbbbbffggggggggggggggggmjkkjjjjjjjjjjjjjjjjjjjjkkjf
fggggggggggggggggggggggggggggggggggggggggggggggggggggggggggggggggggggggggggggggggggggggggggggggggggggggggggggggggggggggggggggcbbbbfffffbbbbffggggggggggggggggmmkkjjjjjjjjjjjjjjjjjjjjkkjf
fggggggggggggggggggggggggggggggggggggggggggggggggggggggggggggggggggggggggggggggggggggggggggggggggggggggggggggggggggggggggggggfbbfffffffbbbbffggggggggggggggggkkkkjjjjjjjjjjjjkkkkkkkkkkjf
fggggggggggggggggggggggggggggggggggggggggggggggggggggggggggggggggggggggggggggggggggggggggggggggggggggggggggggggggggggggggggggfbbfffffffbbbbffggggggggggggggggkkkkjjjjjjjjjjjjkkkkkkkkkkjf
fggggggggggggggggggggggggggggggggggggggggggggggggggggggggggggggggggggggggggggggggggggggggggggggggggggggggggggggggggggggggggggfbbfffffffbbbbffggggggggggggggggmmkkkkkkkkkkkkkkkkkkkkkkkkjf
fggggggggggggggggggggggggggggggggggggggggggggggggggggggggggggggggggggggggggggggggggggggggggggggggggggggggggggggggggggggggggggfqqffffffbbbbbffggggggggggggggggmjkkkkkkkkkkkkkkkkkkkkkkkkjf
fggggggggggggggggggggggggggggggggggggggggggggggggggggggggggggggggggggggggggggggggggggggggggggggggggggggggggggggggggggggggggggfffffffffbbbbbffggggggggggggggggmjkkkkkkkkkkkkjjkkkkkkkkkkjf
fggggggggggggggggggggggggggggggggggggggggggggggggggggggggggggggggggggggggggggggggggggggggggggggggggggggggggggggggggggggggggggfffffffffbbbbbffggggggggggggggggjjkkkkkkkkkkkkjjkkkkkkkkkkjf
fggggggggggggggggggggggggggggggggggggggggggggggggggggggggggggggggggggggggggggggggggggggggggggggggggggggggggggggggggggggggggggffffffffffbbbbffggggggggggggggggjjkkkkkkkkkkkkjjkkkkkkkkkkjf
fggggggggggggggggggggggggggggggggggggggggggggggggggggggggggggggggggggggggggggggggggggggggggggggggggggggggggggggggggggggggggggffffffffffbbbbffggggggggggggggggjjkkkkkkkkkkkkjjkkkkkkkkkkjf
fggggggggggggggggggggggggggggggggggggggggggggggggggggggggggggggggggggggggggggggggggggggggggggggggggggggggggggggggggggggggggggaaaaaaaaaabbbbffggggggggggggggggjjjjjkkjjjjjjjjjjjjjjjjjjjjf
fggggggggggggggggggggggggggggggggggggggggggggggggggggggggggggggggggggggggggggggggggggggggggggggggggggggggggggggggggggggggggggabbbabbbbabbbbffggggggggggggggggjjjjjkkjjjjjjjjjjjjjjjjjjjjf
fggggggggggggggggggggggggggggggggggggggggggggggggggggggggggggggggggggggggggggggggggggggggggggggggggggggggggggggggggggggggggggabbbabbbbabbbbffggggggggggggggggjjkkkkkkkkkkkkkjjkkkkkkkkjjf
fggggggggggggggggggggggggggggggggggggggggggggggggggggggggggggggggggggggggggggggggggggggggggggggggggggggggggggggggggggggggggggabbbabbbbabbbbffggggggggggggggggjjkkkkkkkkkkkkkjjkkkkkkkkjjf
fggggggggggggggggggggggggggggggggggggggggggggggggggggggggggggggggggggggggggggggggggggggggggggggggggggggggggggggggggggggggggggabbbibbbbbbbbbffggggggggggggggggjjkkkkkkkkkkkkkkkkkkkkkkkjjf
fggggggggggggggggggggggggggggggggggggggggggggggggggggggggggggggggggggggggggggggggggggggggggggggggggggggggggggggggggggggggggggabbbibbbbbbbbbffggggggggggggggggjjkkkkkkkkkkkkkkkkkkkkkkkjjf
fggggggggggggggggggggggggggggggggggggggggggggggggggggggggggggggggggggggggggggggggggggggggggggggggggggggggggggggggggggggggggggabbbabbbbbhhhhffggggggggggggggggjjkkkkkkkkkkkkkjjkkkkkkkkjjf
fggggggggggggggggggggggggggggggggggggggggggggggggggggggggggggggggggggggggggggggggggggggggggggggggggggggggggggggggggggggggggggabbbbbbbbahhhhffggggggggggggggggjjkkkkkkkkkkkkkjjkkkkkkkkjjf
fggggggggggggggggggggggggggggggggggggggggggggggggggggggggggggggggggggggggggggggggggggggggggggggggggggggggggggggggggggggggggggabbaaaaaaahhhhffggggggggggggggggjjkkkkkkkkkkkkkjjkkkkkkkkjjf
fggggggggggggggggggggggggggggggggggggggggggggggggggggggggggggggggggggggggggggggggggggggggggggggggggggggggggggggggggggggggggggabbbbbbbbahhhhffggggggggggggggggjjkkkkkkkkkkkkkjjkkkkkkkkjjf
fggggggggggggggggggggggggggggggggggggggggggggggggggggggggggggggggggggggggggggggggggggggggggggggggggggggggggggggggggggggggggggabbbbbbbbabbbbffggggggggggggggggjjjjjjjkkjjjjjjjjjjjjjjjjjjf
fggggggggggggggggggggggggggggggggggggggggggggggggggggggggggggggggggggggggggggggggggggggggggggggggggggggggggggggggggggggggggggabbbbbbbbahhhhffggggggggggggggggjjjjjjjkkjjjjjjjjjjjjjjjjjjf
fggggggggggggggggggggggggggggggggggggggggggggggggggggggggggggggggggggggggggggggggggggggggggggggggggggggggggggggggggggggggggggabbaaaaaaahhhhffggggggggggggggggfffffjkkkkjfffffffffffffffff
fggggggggggggggggggggggggggggggggggggggggggggggggggggggggggggggggggggggggggggggggggggggggggggggggggggggggggggggggggggggggggggabbbbbbbbabbhbffggggggggggggggggfffffjkkkkjfffffffffffffffff
fggggggggggggggggggggggggggggggggggggggggggggggggggggggggggggggggggggggggggggggggggggggggggggggggggggggggggggggggggggggggggggabbbbbbbbahhhhffggggggggggggggggfffffjkkkkjfffffffffffffffff
fggggggggggggggggggggggggggggggggggggggggggggggggggggggggggggggggggggggggggggggggggggggggggggggggggggggggggggggggggggggggggggabbbbbbbbahhhhffggggggggggggggggfffffmkkkkmfffffffffffffffff
fggggggggggggggggggggggggggggggggggggggggggggggggggggggggggggggggggggggggggggggggggggggggggggggggggggggggggggggggggggggggggggaaaaaaaaaabhhbaaggggggggggggggggfffffmmkkkmfffffffffffffffff
fggggggggggggggggggggggggggggggggggggggggggggggggggggggggggggggggggggggggggggggggggggggggggggggggggggggggggggggggggggggggggggfbbbggbhhhhhhhbbggggggggggggggggfffffmonnomfffffffffffffffff
fggggggggggggggggggggggggggggggggggggggggggggggggggggggggggggggggggggggggggggggggggggggggggggggggggggggggggggggggggggggggggggfbbbggbbhhhhhhbbggggggggggggggggfffffmnnnnmfffffffffffffffff
fggggggggggggggggggggggggggggggggggggggggggggggggggggggggggggggggggggggggggggggggggggggggggggggggggggggggggggggggggggggggggggfbbbggbbbhhhhhbbgggggggggggggggggffffmonnomfffffffffffffffff
fggggggggggggggggggggggggggggggggggggggggggggggggggggggggggggggggggggggggggggggggggggggggggggggggggggggggggggggggggggggggggggfbbbggbbbbbbbbaaggggggggggggggggggggfmmppmmfffffffffffffffff
fggggggggggggggggggggggggggggggggggggggggggggggggggggggggggggggggggggggggggggggggggggggggggggggggggggggggggggggggggggggggggggfbbbggbbbbbbbbffggggggggggggggggggggffppppffffffffffffffffff
fggggggggggggggggggggggggggggggggggggggggggggggggggggggggggggggggggggggggggggggggggggggggggggggggggggggggggggggggggggggggggggbbbbhhbbbbbbbbffggggggggggggggggggggffppppffffffffffffffffff
fggggggggggggggggggggggggggggggggggggggggggggggggggggggggggggggggggggggggggggggggggggggggggggggggggggggggggggggggggggggggggggbbbbhhbbbbbbbbffggggggggggggggggggggffppppffffffffffffffffff
fggggggggggggggggggggggggggggggggggggggggggggggggggggggggggggggggggggggggggggggggggggggggggggggggggggggggggggggggggggggggggggbbbbhhbbbbbbbbffffffffabbbafffffffffffbppbffffffffffffffffff
fggggggggggggggggggggggggggggggggggggggggggggggggggggggggggggggggggggggggggggggggggggggggggggggggggggggggggggggggggggggggggggfbbbggbbbbbbbbffffffffabbbaffffffffffppppppffaaaaaaaaaaaaaff
fggggggggggggggggggggggggggggggggggggggggggggggggggggggggggggggggggggggggggggggggggggggggggggggggggggggggggggggggggggggggggggfbbbggbbbbbbbbbbbbbbbbbbbbbbbbbbbbbbbbbbbbbbbbbbbbbbbbbbbaff
fggggggggggggggggggggggggggggggggggggggggggggggggggggggggggggggggggggggggggggggggggggggggggggggggggggggggggggggggggggggggggggfbbbggbbbbbbbbbbbbbbbbbbbbbbbbbbbbbbbbbbbbbbbbbbbbbbbbbbbaff
fggggggggggggggggggggggggggggggggggggggggggggggggggggggggggggggggggggggggggggggggggggggggggggggggggggggggggggggggggggggggggggfbbbggbbbbbbbbbbbbbbbbbbbbbbbbbbbbbbbbbbbbbbbbbbbbbbbbbbbaff
fggggggggggggggggggggggggggggggggggggggggggggggggggggggggggggggggggggggggggggggggggggggggggggggggggggggggggggggggggggggggggggfbbbggbbbbbbbbbbbbbbbbbbbbbbbbbbbbbbbbbbbbbbbabbbbbbbbbbbaff
fggggggggggggggggggggggggggggggggggggggggggggggggggggggggggggggggggggggggggggggggggggggggggggggggggggggggggggggggggggggggggggfbbbggbbbbbbbbffbbbbffbbbbbbbbbbbbbbffbbbbfffaaabbbbbbbbbaff
fggggggggggggggggggggggggggggggggggggggggggggggggggggggggggggggggggggggggggggggggggggggggggggggggggggggggggggggggggggggggggggfffffffbbbbbbbffbbbbffbbbbbbbbbbbbbbffbbbbfffffabbbbbbbbbaff
fggggggggggggggggggggggggggggggggggggggggggggggggggggggggggggggggggggggggggggggggggggggggggggggggggggggggggggggggggggggggggggfffffffbbbbbbbffbbbbffbbbffffbbbbbbbffbbbbfffffabbbbbbbbbaff
fggggggggggggggggggggggggggggggggggggggggggggggggggggggggggggggggggggggggggggggggggggggggggggggggggggggggggggggggggggggggggggfffffffbbbbbbbffggggfffffffffbbbbbbbffbbbbfffffabbbbbbbbbaff
fggggggggggggggggggggggggggggggggggggggggggggggggggggggggggggggggggggggggggggggggggggggggggggggggggggggggggggggggggggggggggggffffffffffffffffggggfffffffffbbbbbbbffbbbbfffffabbbbbbbbbaff
fggggggggggggggggggggggggggggggggggggggggggggggggggggggggggggggggggggggggggggggggggggggggggggggggggggggggggggggggggggggggggggffffffffffffffffggggffffffffbbbbbbbbffbbbbfffffabbbbbbbbbaff
fggggggggggggggggggggggggggggggggggggggggggggggggggggggggggggggggggggggggggggggggggggggggggggggggggggggggggggggggggggggggggggffffgggggggggggggggggggggggfbbbbbbbbffbbbbfffffaaaaaaaaaaaff
fggggggggggggggggggggggggggggggggggggggggggggggggggggggggggggggggggggggggggggggggggggggggggggggggggggggggggggggggggggggggggggffffgggggggggggggggggggggggffbbbbbbfffbbbbffffffffffffffffff
fggggggggggggggggggggggggggggggggggggggggggggggggggggggggggggggggggggggggggggggggggggggggggggggggggggggggggggggggggggggggggggffffgggggggggggggggggggggggfffffffffffbbbbffffffffffffffffff
fggggggggggggggggggggggggggggggggggggggggggggggggggggggggggggggggggggggggggggggggggggggggggggggggggggggggggggggggggggggggggggffffgggggggggggggggggggggggfffffffffffbbbbffffffffffffffffff
fggggggggggggggggggggggggggggggggggggggggggggggggggggggggggggggggggggggggggggggggggggggggggggggggggggggggggggggggggggggggggggffffgggggggggggggggggggggggfffffffffffbbbbffffffffffffffffff
fggggggggggggggggggggggggggggggggggggggggggggggggggggggggggggggggggggggggggggggggggggggggggggggggggggggggggggggggggggggggggggffffgggggggggggggggggggggggfffffffffffbbbbffffffffffffffffff
fggggggggggggggggggggggggggggggggggggggggggggggggggggggggggggggggggggggggggggggggggggggggggggggggggggggggggggggggggggggggggggffffgggggggggggggggggggggggfffffffffffbbbbffffffffffffffffff
fggggggggggggggggggggggggggggggggggggggggggggggggggggggggggggggggggggggggggggggggggggggggggggggggggggggggggggggggggggggggggggffffgggggggggggggggggggggggfffffffffffbbbbffffffffffffffffff
fggggggggggggggggggggggggggggggggggggggggggggggggggggggggggggggggggggggggggggggggggggggggggggggggggggggggggggggggggggggggggggffffgggggggggggggggggggggggfffffffffffbbbbffffffffffffffffff
fggggggggggggggggggggggggggggggggggggggggggggggggggggggggggggggggggggggggggggggggggggggggggggggggggggggggggggggggggggggggggggffffgggggggggggggggggggggggffffffbbbbbbbbbbbbbbbbbbfffffffff
fggggggggggggggggggggggggggggggggggggggggggggggggggggggggggggggggggggggggggggggggggggggggggggggggggggggggggggggggggggggggggggffffgggggggggggggggggggggggffffffbbbbbbbbbbbbbbbbbbfffffffff
fggggggggggggggggggggggggggggggggggggggggggggggggggggggggggggggggggggggggggggggggggggggggggggggggggggggggggggggggggggggggggggffffgggggggggggggggggggggggffffffbbbbbbbabaaaaaaaaafffffffff
fggggggggggggggggggggggggggggggggggggggggggggggggggggggggggggggggggggggggggggggggggggggggggggggggggggggggggggggggggggggggggggffffgggggggggggggggggggggggfffffbbbbbbbbabbbbbrrrbafffffffff
fggggggggggggggggggggggggggggggggggggggggggggggggggggggggggggggggggggggggggggggggggggggggggggggggggggggggggggggggggggggggggggffffgggggggggggggggggggggggggbbbbbbbbbbbabbbbbbbbbafffffffff
fggggggggggggggggggggggggggggggggggggggggggggggggggggggggggggggggggggggggggggggggggggggggggggggggggggggggggggggggggggggggggggffffgggggggggggggggggggggggggbbbbbbbbbbbabbbbbbbbbafffffffff
fggggggggggggggggggggggggggggggggggggggggggggggggggggggggggggggggggggggggggggggggggggggggggggggggggggggggggggggggggggggggggggffffgggggggggggggggggggggggffbbbbbbbbbbbabbbbaaaaaafffffffff
fggggggggggggggggggggggggggggggggggggggggggggggggggggggggggggggggggggggggggggggggggggggggggggggggggggggggggggggggggggggggggggffffgggggggggggggggggggggggfffaaaaaaaaaaabbbbabfffffffffffff
fggggggggggggggggggggggggggggggggggggggggggggggggggggggggggggggggggggggggggggggggggggggggggggggggggggggggggggggggggggggggggggffffgggggggggggggggggggggggfffabbbbbabbbbbbbbabfffffffffffff
fggggggggggggggggggggggggggggggggggggggggggggggggggggggggggggggggggggggggggggggggggggggggggggggggggggggggggggggggggggggggggggffffgggggggggggggggggggggggfffabbbbbabbbbbbbbbbfffffffffffff
fggggggggggggggggggggggggggggggggggggggggggggggggggggggggggggggggggggggggggggggggggggggggggggggggggggggggggggggggggggggggggggffffgggggggggggggggggggggggfffabbbbbbbbbbbbbbaffffffffffffff
fggggggggggggggggggggggggggggggggggggggggggggggggggggggggggggggggggggggggggggggggggggggggggggggggggggggggggggggggggggggggggggffffgggggggggggggggggggggggfffaaaaaaaaaaaaaaaaffffffffffffff
fggggggggggggggggggggggggggggggggggggggggggggggggggggggggggggggggggggggggggggggggggggggggggggggggggggggggggggggggggggggggggggffffgggggggggggggggggggggggfffffffffffffffffffffffffffffffff
fggggggggggggggggggggggggggggggggggggggggggggggggggggggggggggggggggggggggggggggggggggggggggggggggggggggggggggggggggggggggggggffffffffffffffffffffffffffffffffffffffffffffffffffffffffffff
fggggggggggggggggggggggggggggggggggggggggggggggggggggggggggggggggggggggggggggggggggggggggggggggggggggggggggggggggggggggggggggffffffffffffffffffffffffffffffffffffffffffffffffffffffffffff
fgggggggggggggggggggggggggggggggggggggggggggggggggggggggggggggggggggggggggggggggggggggggggggggggggggggggggggggggggggggggggggggggggggggggggggggggggggggggggggggggggggggggggggggggggggggggg
fgggggggggggggggggggggggggggggggggggggggggggggggggggggggggggggggggggggggggggggggggggggggggggggggggggggggggggggggggggggggggggggggggggggggggggggggggggggggggggggggggggggggggggggggggggggggg
fgggggggggggggggggggggggggggggggggggggggggggggggggggggggggggggggggggggggggggggggggggggggggggggggggggggggggggggggggggggggggggggggggggggggggggggggggggggggggggggggggggggggggggggggggggggggg
fgggggggggggggggggggggggggggggggggggggggggggggggggggggggggggggggggggggggggggggggggggggggggggggggggggggggggggggggggggggggggggggggggggggggggggggggggggggggggggggggggggggggggggggggggggggggg
fgggggggggggggggggggggggggggggggggggggggggggggggggggggggggggggggggggggggggggggggggggggggggggggggggggggggggggggggggggggggggggggggggggggggggggggggggggggggggggggggggggggggggggggggggggggggg
fgggggggggggggggggggggggggggggggggggggggggggggggggggggggggggggggggggggggggggggggggggggggggggggggggggggggggggggggggggggggggggggggggggggggggggggggggggggggggggggggggggggggggggggggggggggggg
fgggggggggggggggggggggggggggggggggggggggggggggggggggggggggggggggggggggggggggggggggggggggggggggggggggggggggggggggggggggggggggggggggggggggggggggggggggggggggggggggggggggggggggggggggggggggg
fgggggggggggggggggggggggggggggggggggggggggggggggggggggggggggggggggggggggggggggggggggggggggggggggggggggggggggggggggggggggggggggggggggggggggggggggggggggggggggggggggggggggggggggggggggggggg
fgggggggggggggggggggggggggggggggggggggggggggggggggggggggggggggggggggggggggggggggggggggggggggggggggggggggggggggggggggggggggggggggggggggggggggggggggggggggggggggggggggggggggggggggggggggggg
fgggggggggggggggggggggggggggggggggggggggggggggggggggggggggggggggggggggggggggggggggggggggggggggggggggggggggggggggggggggggggggggggggggggggggggggggggggggggggggggggggggggggggggggggggggggggg
fgggggggggggggggggggggggggggggggggggggggggggggggggggggggggggggggggggggggggggggggggggggggggggggggggggggggggggggggggggggggggggggggggggggggggggggggggggggggggggggggggggggggggggggggggggggggg
fgggggggggggggggggggggggggggggggggggggggggggggggggggggggggggggggggggggggggggggggggggggggggggggggggggggggggggggggggggggggggggggggggggggggggggggggggggggggggggggggggggggggggggggggggggggggg
fgggggggggggggggggggggggggggggggggggggggggggggggggggggggggggggggggggggggggggggggggggggggggggggggggggggggggggggggggggggggggggggggggggggggggggggggggggggggggggggggggggggggggggggggggggggggg
fgggggggggggggggggggggggggggggggggggggggggggggggggggggggggggggggggggggggggggggggggggggggggggggggggggggggggggggggggggggggggggggggggggggggggggggggggggggggggggggggggggggggggggggggggggggggg
fgggggggggggggggggggggggggggggggggggggggggggggggggggggggggggggggggggggggggggggggggggggggggggggggggggggggggggggggggggggggggggggggggggggggggggggggggggggggggggggggggggggggggggggggggggggggg
fgggggggggggggggggggggggggggggggggggggggggggggggggggggggggggggggggggggggggggggggggggggggggggggggggggggggggggggggggggggggggggggggggggggggggggggggggggggggggggggggggggggggggggggggggggggggg
fgggggggggggggggggggggggggggggggggggggggggggggggggggggggggggggggggggggggggggggggggggggggggggggggggggggggggggggggggggggggggggggggggggggggggggggggggggggggggggggggggggggggggggggggggggggggg
fgggggggggggggggggggggggggggggggggggggggggggggggggggggggggggggggggggggggggggggggggggggggggggggggggggggggggggggggggggggggggggggggggggggggggggggggggggggggggggggggggggggggggggggggggggggggg
fgggggggggggggggggggggggggggggggggggggggggggggggggggggggggggggggggggggggggggggggggggggggggggggggggggggggggggggggggggggggggggggggggggggggggggggggggggggggggggggggggggggggggggggggggggggggg
fgggggggggggggggggggggggggggggggggggggggggggggggggggggggggggggggggggggggggggggggggggggggggggggggggggggggggggggggggggggggggggggggggggggggggggggggggggggggggggggggggggggggggggggggggggggggg
fffffffffffffffffffffffffffffffffffffffffffffffffffffffffffffffffffffffffffffffffffffffffffffffffffffffffffffffffffffffffffffffffffffffffffffffffffffffffffffffffffffffffffffffffffffffff
"}
