"b" = (/turf/open/floor/plating/polovich/rockydarkness,/area/maintenance/polovich/forest/rain)
"c" = (/obj/structure/railing{dir = 8},/turf/open/floor/plating/polovich/rockydarkness,/area/maintenance/polovich/forest/rain)
"f" = (/turf/closed/wall/purple/nocling,/area/maintenance/polovich/forest/rain)
"g" = (/turf/open/openspace/norm,/area/maintenance/polovich/forest/rain)

(1,1,1) = {"
fffffffffffffffffffffffffffffffffffffffffffffffffffffffffffffffffffffffffffffffffffffffffffffffffffffffffffffffffffffffffffffffffffffffffffffffffffffffffffffffffffffffffffffffffffffffff
fgggggggggggggggggggggggggggggggggggggggggggggggggggggggggggggggggggggggggggggggggggggggggggggggggggggggggggggggggggggffgggggggggggggffffffffffffffffffffffffffffffffffffffffffffffffffff
fgggggggggggggggggggggggggggggggggggggggggggggggggggggggggggggggggggggggggggggggggggggggggggggggggggggggggggggggggggggffgggggggggggggffffffffffffffffffffffffffffffffffffffffffffffffffff
fgggggggggggggggggggggggggggggggggggggggggggggggggggggggggggggggggggggggggggggggggggggggggggggggggggggggggggggggggggggffgggggggggggggffffffffffffffffffffffffffffffffffffffffffffffffffff
fgggggggggggggggggggggggggggggggggggggggggggggggggggggggggggggggggggggggggggggggggggggggggggggggggggggggggggggggggggggffgggggggggggggffffffffffffffffffffffffffffffffffffffffffffffffffff
fgggggggggggggggggggggggggggggggggggggggggggggggggggggggggggggggggggggggggggggggggggggggggggggggggggggggggggggggggggggffgggggggggggggffffffffffffffffffffffffffffffffffffffffffffffffffff
fgggggggggggggggggggggggggggggggggggggggggggggggggggggggggggggggggggggggggggggggggggggggggggggggggggggggggggggggggggggffgggggggggggggffffffffffffffffffffffffffffffffffffffffffffffffffff
fgggggggggggggggggggggggggggggggggggggggggggggggggggggggggggggggggggggggggggggggggggggggggggggggggggggggggggggggggggggffgggggggggggggffffffffffffffffffffffffffffffffffffffffffffffffffff
fgggggggggggggggggggggggggggggggggggggggggggggggggggggggggggggggggggggggggggggggggggggggggggggggggggggggggggggggggggggffgggggggggggggffbbbbffffffffffffffffffffffffffffffffffffffffffffff
fgggggggggggggggggggggggggggggggggggggggggggggggggggggggggggggggggggggggggggggggggggggggggggggggggggggggggggggggggggggffgggggggggggggffbbbbffffffffffffffffffffffffffffffffffffffffffffff
fgggggggggggggggggggggggggggggggggggggggggggggggggggggggggggggggggggggggggggggggggggggggggggggggggggggggggggggggggggggffgggggggggggggffbbbbffffffffffffffffffffffffffffffffffffffffffffff
fgggggggggggggggggggggggggggggggggggggggggggggggggggggggggggggggggggggggggggggggggggggggggggggggggggggggggggggggggggggffgggggggggggggffbbbbffffffffffffffffffffffffffffffffffffffffffffff
fgggggggggggggggggggggggggggggggggggggggggggggggggggggggggggggggggggggggggggggggggggggggggggggggggggggggggggggggggggggffggggggggggggggbbbbbffffffffffffffffffffffffffffffffffffffffffffff
fgggggggggggggggggggggggggggggggggggggggggggggggggggggggggggggggggggggggggggggggggggggggggggggggggggggggggggggggggggggffggggggggggggggbbbbbffffffffffffffffffffffffffffffffffffffffffffff
fgggggggggggggggggggggggggggggggggggggggggggggggggggggggggggggggggggggggggggggggggggggggggggggggggggggggggggggggggggggffggggggggggggggbbbbbffffffffffffffffffffffffffffffffffffffffffffff
fgggggggggggggggggggggggggggggggggggggggggggggggggggggggggggggggggggggggggggggggggggggggggggggggggggggggggggggggggggggffgggggggggggggffbbbbffffffffffffffffffffffffffffffffffffffffffffff
fgggggggggggggggggggggggggggggggggggggggggggggggggggggggggggggggggggggggggggggggggggggggggggggggggggggggggggggggggggggffgggggggggggggffbbbbffffffffffffffffffffffffffffffffffffffffffffff
fgggggggggggggggggggggggggggggggggggggggggggggggggggggggggggggggggggggggggggggggggggggggggggggggggggggggggggggggggggggffgggggggggggggffbbbbffffffffffffffffffffffffffffffffffffffffffffff
fgggggggggggggggggggggggggggggggggggggggggggggggggggggggggggggggggggggggggggggggggggggggggggggggggggggggggggggggggggggffgggggggggggggffbbbbffffffffffffffffffffffffffffffffffffffffffffff
fgggggggggggggggggggggggggggggggggggggggggggggggggggggggggggggggggggggggggggggggggggggggggggggggggggggggggggggggggggggffgggggggggggggffbbbbffffffffffffffffffffffffffffffffffffffffffffff
fgggggggggggggggggggggggggggggggggggggggggggggggggggggggggggggggggggggggggggggggggggggggggggggggggggggggggggggggggggggffgggggggggggggffbbbbffffffffffffffffffffffffffffffffffffffffffffff
fgggggggggggggggggggggggggggggggggggggggggggggggggggggggggggggggggggggggggggggggggggggggggggggggggggggggggggggggggggggffgggggggggggggffbbbbffffffffffffffffffffffffffffffffffffffffffffff
fgggggggggggggggggggggggggggggggggggggggggggggggggggggggggggggggggggggggggggggggggggggggggggggggggggggggggggggggggggggffgggggggggggggffbbbbffffffffffffffffffffffffffffffffffffffffffffff
fgggggggggggggggggggggggggggggggggggggggggggggggggggggggggggggggggggggggggggggggggggggggggggggggggggggggggggggggggggggffgggggggggggggffbbbbffffffffffffffffffffffffffffffffffffffffffffff
fgggggggggggggggggggggggggggggggggggggggggggggggggggggggggggggggggggggggggggggggggggggggggggggggggggggggggggggggggggggffgggggggggggggffbbbbffffffffffffffffffffffffffffffffffffffffffffff
fgggggggggggggggggggggggggggggggggggggggggggggggggggggggggggggggggggggggggggggggggggggggggggggggggggggggggggggggggggggffffffffffffgggffbbbbffffffffffffffffffffffffffffffffffffffffffffff
fggggggggggggggggggggggggggggggggggggggggggggggggggggggggggggggggggggggggggggggggggggggggggggggggggggggggggggggggggggggffffffffffffggffbbbbffffffffffffffffffffffffffffffffffffffffffffff
fggggggggggggggggggggggggggggggggggggggggggggggggggggggggggggggggggggggggggggggggggggggggggggggggggggggggggggggggggggggggggggcbbbffffffbbbbffffffffffffffffffffffffffffffffffffffffffffff
fggggggggggggggggggggggggggggggggggggggggggggggggggggggggggggggggggggggggggggggggggggggggggggggggggggggggggggggggggggggggggggcbbbbfffffbbbbffffffffffffffffffffffffffffffffffffffffffffff
fggggggggggggggggggggggggggggggggggggggggggggggggggggggggggggggggggggggggggggggggggggggggggggggggggggggggggggggggggggggggggggbbbbbbbbbbbbbbffffffffffffffffffffffffffffffffffffffffffffff
fggggggggggggggggggggggggggggggggggggggggggggggggggggggggggggggggggggggggggggggggggggggggggggggggggggggggggggggggggggggggggggbbbbbbbbbbbbbbffffffffffffffffffffffffffffffffffffffffffffff
fggggggggggggggggggggggggggggggggggggggggggggggggggggggggggggggggggggggggggggggggggggggggggggggggggggggggggggggggggggggggggggbbbbbbbbbbbbbbffffffffffffffffffffffffffffffffffffffffffffff
fggggggggggggggggggggggggggggggggggggggggggggggggggggggggggggggggggggggggggggggggggggggggggggggggggggggggggggggggggggggggggggbbbbbbbbbbbbbbffffffffffffffffffffffffffffffffffffffffffffff
fggggggggggggggggggggggggggggggggggggggggggggggggggggggggggggggggggggggggggggggggggggggggggggggggggggggggggggggggggggggggggggcbbbbfffffbbbbffffffffffffffffffffffffffffffffffffffffffffff
fggggggggggggggggggggggggggggggggggggggggggggggggggggggggggggggggggggggggggggggggggggggggggggggggggggggggggggggggggggggggggggcbbbffffffbbbbffffffffffffffffffffffffffffffffffffffffffffff
fggggggggggggggggggggggggggggggggggggggggggggggggggggggggggggggggggggggggggggggggggggggggggggggggggggggggggggggggggggggggggggfbbfffffffbbbbffffffffffffffffffffffffffffffffffffffffffffff
fggggggggggggggggggggggggggggggggggggggggggggggggggggggggggggggggggggggggggggggggggggggggggggggggggggggggggggggggggggggggggggfbbffbbbffbbbbffffffffffffffffffffffffffffffffffffffffffffff
fggggggggggggggggggggggggggggggggggggggggggggggggggggggggggggggggggggggggggggggggggggggggggggggggggggggggggggggggggggggggggggfbbffbbbffbbbbffffffffffffffffffffffffffffffffffffffffffffff
fggggggggggggggggggggggggggggggggggggggggggggggggggggggggggggggggggggggggggggggggggggggggggggggggggggggggggggggggggggggggggggfbbffbbbbbbbbbffffffffffffffffffffffffffffffffffffffffffffff
fggggggggggggggggggggggggggggggggggggggggggggggggggggggggggggggggggggggggggggggggggggggggggggggggggggggggggggggggggggggggggggfbbffbbbbbbbbbffffffffffffffffffffffffffffffffffffffffffffff
fggggggggggggggggggggggggggggggggggggggggggggggggggggggggggggggggggggggggggggggggggggggggggggggggggggggggggggggggggggggggggggfffffbbbbbbbbbffffffffffffffffffffffffffffffffffffffffffffff
fggggggggggggggggggggggggggggggggggggggggggggggggggggggggggggggggggggggggggggggggggggggggggggggggggggggggggggggggggggggggggggfffffbbbbbbbbbffffffffffffffffffffffffffffffffffffffffffffff
fggggggggggggggggggggggggggggggggggggggggggggggggggggggggggggggggggggggggggggggggggggggggggggggggggggggggggggggggggggggggggggfbbbbbbbbbbbbbffffffffffffffffffffffffffffffffffffffffffffff
fggggggggggggggggggggggggggggggggggggggggggggggggggggggggggggggggggggggggggggggggggggggggggggggggggggggggggggggggggggggggggggfbbbbbbbbbbbbbffffffffffffffffffffffffffffffffffffffffffffff
fggggggggggggggggggggggggggggggggggggggggggggggggggggggggggggggggggggggggggggggggggggggggggggggggggggggggggggggggggggggggggggfbbbbbbbbbbbbbffffffffffffffffffffffffffffffffffffffffffffff
fggggggggggggggggggggggggggggggggggggggggggggggggggggggggggggggggggggggggggggggggggggggggggggggggggggggggggggggggggggggggggggfbbbbbbbbbbbbbffffffffffffffffffffffffffffffffffffffffffffff
fggggggggggggggggggggggggggggggggggggggggggggggggggggggggggggggggggggggggggggggggggggggggggggggggggggggggggggggggggggggggggggfbbbbbbbbbbbbbffffffffffffffffffffffffffffffffffffffffffffff
fggggggggggggggggggggggggggggggggggggggggggggggggggggggggggggggggggggggggggggggggggggggggggggggggggggggggggggggggggggggggggggfbbbbbbbbbbbbbffffffffffffffffffffffffffffffffffffffffffffff
fggggggggggggggggggggggggggggggggggggggggggggggggggggggggggggggggggggggggggggggggggggggggggggggggggggggggggggggggggggggggggggfbbbbbbbbbbbbbffffffffffffffffffffffffffffffffffffffffffffff
fggggggggggggggggggggggggggggggggggggggggggggggggggggggggggggggggggggggggggggggggggggggggggggggggggggggggggggggggggggggggggggfbbbbbbbbbbbbbffffffffffffffffffffffffffffffffffffffffffffff
fggggggggggggggggggggggggggggggggggggggggggggggggggggggggggggggggggggggggggggggggggggggggggggggggggggggggggggggggggggggggggggfbbbbbbbbbbbbbffffffffffffffffffffffffffffffffffffffffffffff
fggggggggggggggggggggggggggggggggggggggggggggggggggggggggggggggggggggggggggggggggggggggggggggggggggggggggggggggggggggggggggggfbbbbbbbbbbbbbffffffffffffffffffffffffffffffffffffffffffffff
fggggggggggggggggggggggggggggggggggggggggggggggggggggggggggggggggggggggggggggggggggggggggggggggggggggggggggggggggggggggggggggfbbbbbbbbbbbbbffffffffffffffffffffffffffffffffffffffffffffff
fggggggggggggggggggggggggggggggggggggggggggggggggggggggggggggggggggggggggggggggggggggggggggggggggggggggggggggggggggggggggggggfbbbbbbbbbbbbbffffffffffffffffffffffffffffffffffffffffffffff
fggggggggggggggggggggggggggggggggggggggggggggggggggggggggggggggggggggggggggggggggggggggggggggggggggggggggggggggggggggggggggggfbbbbbbbbbbbbbffffffffffffffffffffffffffffffffffffffffffffff
fggggggggggggggggggggggggggggggggggggggggggggggggggggggggggggggggggggggggggggggggggggggggggggggggggggggggggggggggggggggggggggfbbbbbbbbbbbbbffffffffffffffffffffffffffffffffffffffffffffff
fggggggggggggggggggggggggggggggggggggggggggggggggggggggggggggggggggggggggggggggggggggggggggggggggggggggggggggggggggggggggggggfbbbbbbbbbbbbbffffffffffffffffffffffffffffffffffffffffffffff
fggggggggggggggggggggggggggggggggggggggggggggggggggggggggggggggggggggggggggggggggggggggggggggggggggggggggggggggggggggggggggggfbbbbbbbbbbbbbffffffffffffffffffffffffffffffffffffffffffffff
fggggggggggggggggggggggggggggggggggggggggggggggggggggggggggggggggggggggggggggggggggggggggggggggggggggggggggggggggggggggggggggfbbbbbbbbbbbbbffffffffffffffffffffffffffffffffffffffffffffff
fggggggggggggggggggggggggggggggggggggggggggggggggggggggggggggggggggggggggggggggggggggggggggggggggggggggggggggggggggggggggggggfbbbbbbbbbbbbbffffffffffffffffffffffffffffffffffffffffffffff
fggggggggggggggggggggggggggggggggggggggggggggggggggggggggggggggggggggggggggggggggggggggggggggggggggggggggggggggggggggggggggggfbbbbbbbbbbbbbffffffffffffffffffffffffffffffffffffffffffffff
fggggggggggggggggggggggggggggggggggggggggggggggggggggggggggggggggggggggggggggggggggggggggggggggggggggggggggggggggggggggggggggfbbbbbbbbbbbbbffffffffffffffffffffffffffffffffffffffffffffff
fggggggggggggggggggggggggggggggggggggggggggggggggggggggggggggggggggggggggggggggggggggggggggggggggggggggggggggggggggggggggggggfbbbbbbbbbbbbbffffffffffffffffffffffffffffffffffffffffffffff
fggggggggggggggggggggggggggggggggggggggggggggggggggggggggggggggggggggggggggggggggggggggggggggggggggggggggggggggggggggggggggggfbbbbbbbbbbbbbffffffffffffffffffffffffffffffffffffffffffffff
fggggggggggggggggggggggggggggggggggggggggggggggggggggggggggggggggggggggggggggggggggggggggggggggggggggggggggggggggggggggggggggfbbbbbbbbbbbbbffffffffffffffffffffffffffffffffffffffffffffff
fggggggggggggggggggggggggggggggggggggggggggggggggggggggggggggggggggggggggggggggggggggggggggggggggggggggggggggggggggggggggggggfbbbbbbbbbbbbbffffffffffffffffffffffffffffffffffffffffffffff
fggggggggggggggggggggggggggggggggggggggggggggggggggggggggggggggggggggggggggggggggggggggggggggggggggggggggggggggggggggggggggggfbbbbbbbbbbbbbffffffffffffffffffffffffffffffffffffffffffffff
fggggggggggggggggggggggggggggggggggggggggggggggggggggggggggggggggggggggggggggggggggggggggggggggggggggggggggggggggggggggggggggfbbbbbbbbbbbbbffffffffffffffffffffffffffffffffffffffffffffff
fggggggggggggggggggggggggggggggggggggggggggggggggggggggggggggggggggggggggggggggggggggggggggggggggggggggggggggggggggggggggggggfbbbbbbbbbbbbbffffffffffffffffffffffffffffffffffffffffffffff
fggggggggggggggggggggggggggggggggggggggggggggggggggggggggggggggggggggggggggggggggggggggggggggggggggggggggggggggggggggggggggggfbbbbbbbbbbbbbffffffffffffffffffffffffffffffffffffffffffffff
fggggggggggggggggggggggggggggggggggggggggggggggggggggggggggggggggggggggggggggggggggggggggggggggggggggggggggggggggggggggggggggfbbbbbbbbbbbbbffffffffffffffffffffffffffffffffffffffffffffff
fggggggggggggggggggggggggggggggggggggggggggggggggggggggggggggggggggggggggggggggggggggggggggggggggggggggggggggggggggggggggggggfbbbbbbbbbbbbbffffffffffffffffffffffffffffffffffffffffffffff
fggggggggggggggggggggggggggggggggggggggggggggggggggggggggggggggggggggggggggggggggggggggggggggggggggggggggggggggggggggggggggggfbbbbbbbbbbbbbffffffffffffffffffffffffffffffffffffffffffffff
fggggggggggggggggggggggggggggggggggggggggggggggggggggggggggggggggggggggggggggggggggggggggggggggggggggggggggggggggggggggggggggfbbbbbbbbbbbbbffffffffffffffffffffffffffffffffffffffffffffff
fggggggggggggggggggggggggggggggggggggggggggggggggggggggggggggggggggggggggggggggggggggggggggggggggggggggggggggggggggggggggggggfbbbbbbbbbbbbbffffffffffffffffffffffffffffffffffffffffffffff
fggggggggggggggggggggggggggggggggggggggggggggggggggggggggggggggggggggggggggggggggggggggggggggggggggggggggggggggggggggggggggggfbbbbbbbbbbbbbffffffffffffffffffffffffffffffffffffffffffffff
fggggggggggggggggggggggggggggggggggggggggggggggggggggggggggggggggggggggggggggggggggggggggggggggggggggggggggggggggggggggggggggfbbbbbbbbbbbbbffffffffffffffffffffffffffffffffffffffffffffff
fggggggggggggggggggggggggggggggggggggggggggggggggggggggggggggggggggggggggggggggggggggggggggggggggggggggggggggggggggggggggggggfbbbbbbbbbbbbbffffffffffffffffffffffffffffffffffffffffffffff
fggggggggggggggggggggggggggggggggggggggggggggggggggggggggggggggggggggggggggggggggggggggggggggggggggggggggggggggggggggggggggggfbbbbbbbbbbbbbffffffffffffffffffffffffffffffffffffffffffffff
fggggggggggggggggggggggggggggggggggggggggggggggggggggggggggggggggggggggggggggggggggggggggggggggggggggggggggggggggggggggggggggfbbbbbbbbbbbbbffffffffffffffffffffffffffffffffffffffffffffff
fggggggggggggggggggggggggggggggggggggggggggggggggggggggggggggggggggggggggggggggggggggggggggggggggggggggggggggggggggggggggggggfbbbbbbbbbbbbbffffffffffffffffffffffffffffffffffffffffffffff
fggggggggggggggggggggggggggggggggggggggggggggggggggggggggggggggggggggggggggggggggggggggggggggggggggggggggggggggggggggggggggggfbbbbbbbbbbbbbffffffffffffffffffffffffffffffffffffffffffffff
fggggggggggggggggggggggggggggggggggggggggggggggggggggggggggggggggggggggggggggggggggggggggggggggggggggggggggggggggggggggggggggfbbbbbbbbbbbbbffffffffffffffffffffffffffffffffffffffffffffff
fggggggggggggggggggggggggggggggggggggggggggggggggggggggggggggggggggggggggggggggggggggggggggggggggggggggggggggggggggggggggggggfbbbbbbbbbbbbbffffffffffffffffffffffffffffffffffffffffffffff
fggggggggggggggggggggggggggggggggggggggggggggggggggggggggggggggggggggggggggggggggggggggggggggggggggggggggggggggggggggggggggggfbbbbbbbbbbbbbffffffffffffffffffffffffffffffffffffffffffffff
fggggggggggggggggggggggggggggggggggggggggggggggggggggggggggggggggggggggggggggggggggggggggggggggggggggggggggggggggggggggggggggfbbbbbbbbbbbbbffffffffffffffffffffffffffffffffffffffffffffff
fggggggggggggggggggggggggggggggggggggggggggggggggggggggggggggggggggggggggggggggggggggggggggggggggggggggggggggggggggggggggggggfbbbbbbbbbbbbbffffffffffffffffffffffffffffffffffffffffffffff
fggggggggggggggggggggggggggggggggggggggggggggggggggggggggggggggggggggggggggggggggggggggggggggggggggggggggggggggggggggggggggggfbbbbbbbbbbbbbffffffffffffffffffffffffffffffffffffffffffffff
fggggggggggggggggggggggggggggggggggggggggggggggggggggggggggggggggggggggggggggggggggggggggggggggggggggggggggggggggggggggggggggfbbbbbbbbbbbbbffffffffffffffffffffffffffffffffffffffffffffff
fggggggggggggggggggggggggggggggggggggggggggggggggggggggggggggggggggggggggggggggggggggggggggggggggggggggggggggggggggggggggggggfbbbbbbbbbbbbbffffffffffffffffffffffffffffffffffffffffffffff
fggggggggggggggggggggggggggggggggggggggggggggggggggggggggggggggggggggggggggggggggggggggggggggggggggggggggggggggggggggggggggggfbbbbbbbbbbbbbbbbbbbbbbbbbffffffffffffffffffffffffffffffffff
fggggggggggggggggggggggggggggggggggggggggggggggggggggggggggggggggggggggggggggggggggggggggggggggggggggggggggggggggggggggggggggfbbbbbbbbbbbbbbbbbbbbbbbbbffffffffffffffffffffffffffffffffff
fggggggggggggggggggggggggggggggggggggggggggggggggggggggggggggggggggggggggggggggggggggggggggggggggggggggggggggggggggggggggggggfbbbbbbbbbbbbbbbbbbbbbbbbbffffffffffffffffffffffffffffffffff
fggggggggggggggggggggggggggggggggggggggggggggggggggggggggggggggggggggggggggggggggggggggggggggggggggggggggggggggggggggggggggggfbbbbbbbbbbbbbbbbbbbbbbbbbffffffffffffffffffffffffffffffffff
fggggggggggggggggggggggggggggggggggggggggggggggggggggggggggggggggggggggggggggggggggggggggggggggggggggggggggggggggggggggggggggfbbbbbbbbbbbbbbbbbbbbbbbbbffffffffffffffffffffffffffffffffff
fggggggggggggggggggggggggggggggggggggggggggggggggggggggggggggggggggggggggggggggggggggggggggggggggggggggggggggggggggggggggggggfbbbbbbbbbbbbbffbbbbffbbbbbfffffffffffffffffffffffffffffffff
fggggggggggggggggggggggggggggggggggggggggggggggggggggggggggggggggggggggggggggggggggggggggggggggggggggggggggggggggggggggggggggfbbbbbbbbbbbbbffbbbbffbbbbbfffffffffffffffffffffffffffffffff
fggggggggggggggggggggggggggggggggggggggggggggggggggggggggggggggggggggggggggggggggggggggggggggggggggggggggggggggggggggggggggggfbbbbbbbbbbbbbffbbbbffbbbbbfffffffffffffffffffffffffffffffff
fggggggggggggggggggggggggggggggggggggggggggggggggggggggggggggggggggggggggggggggggggggggggggggggggggggggggggggggggggggggggggggffffffffffffffffffffffffffffffffffffffffffffffffffffffffffff
fggggggggggggggggggggggggggggggggggggggggggggggggggggggggggggggggggggggggggggggggggggggggggggggggggggggggggggggggggggggggggggffffffffffffffffffffffffffffffffffffffffffffffffffffffffffff
fggggggggggggggggggggggggggggggggggggggggggggggggggggggggggggggggggggggggggggggggggggggggggggggggggggggggggggggggggggggggggggffffffffffffffffffffffffffffffffffffffffffffffffffffffffffff
fggggggggggggggggggggggggggggggggggggggggggggggggggggggggggggggggggggggggggggggggggggggggggggggggggggggggggggggggggggggggggggffffffffffffffffffffffffffffffffffffffffffffffffffffffffffff
fggggggggggggggggggggggggggggggggggggggggggggggggggggggggggggggggggggggggggggggggggggggggggggggggggggggggggggggggggggggggggggffffffffffffffffffffffffffffffffffffffffffffffffffffffffffff
fggggggggggggggggggggggggggggggggggggggggggggggggggggggggggggggggggggggggggggggggggggggggggggggggggggggggggggggggggggggggggggffffffffffffffffffffffffffffffffffffffffffffffffffffffffffff
fggggggggggggggggggggggggggggggggggggggggggggggggggggggggggggggggggggggggggggggggggggggggggggggggggggggggggggggggggggggggggggffffffffffffffffffffffffffffffffffffffffffffffffffffffffffff
fggggggggggggggggggggggggggggggggggggggggggggggggggggggggggggggggggggggggggggggggggggggggggggggggggggggggggggggggggggggggggggffffffffffffffffffffffffffffffffffffffffffffffffffffffffffff
fggggggggggggggggggggggggggggggggggggggggggggggggggggggggggggggggggggggggggggggggggggggggggggggggggggggggggggggggggggggggggggffffffffffffffffffffffffffffffffffffffffffffffffffffffffffff
fggggggggggggggggggggggggggggggggggggggggggggggggggggggggggggggggggggggggggggggggggggggggggggggggggggggggggggggggggggggggggggffffffffffffffffffffffffffffffffffffffffffffffffffffffffffff
fggggggggggggggggggggggggggggggggggggggggggggggggggggggggggggggggggggggggggggggggggggggggggggggggggggggggggggggggggggggggggggffffffffffffffffffffffffffffffffffffffffffffffffffffffffffff
fggggggggggggggggggggggggggggggggggggggggggggggggggggggggggggggggggggggggggggggggggggggggggggggggggggggggggggggggggggggggggggffffffffffffffffffffffffffffffffffffffffffffffffffffffffffff
fggggggggggggggggggggggggggggggggggggggggggggggggggggggggggggggggggggggggggggggggggggggggggggggggggggggggggggggggggggggggggggffffffffffffffffffffffffffffffffffffffffffffffffffffffffffff
fggggggggggggggggggggggggggggggggggggggggggggggggggggggggggggggggggggggggggggggggggggggggggggggggggggggggggggggggggggggggggggffffffffffffffffffffffffffffffffffffffffffffffffffffffffffff
fggggggggggggggggggggggggggggggggggggggggggggggggggggggggggggggggggggggggggggggggggggggggggggggggggggggggggggggggggggggggggggffffffffffffffffffffffffffffffffffffffffffffffffffffffffffff
fggggggggggggggggggggggggggggggggggggggggggggggggggggggggggggggggggggggggggggggggggggggggggggggggggggggggggggggggggggggggggggffffffffffffffffffffffffffffffffffffffffffffffffffffffffffff
fggggggggggggggggggggggggggggggggggggggggggggggggggggggggggggggggggggggggggggggggggggggggggggggggggggggggggggggggggggggggggggffffffffffffffffffffffffffffffffffffffffffffffffffffffffffff
fggggggggggggggggggggggggggggggggggggggggggggggggggggggggggggggggggggggggggggggggggggggggggggggggggggggggggggggggggggggggggggffffffffffffffffffffffffffffffffffffffffffffffffffffffffffff
fggggggggggggggggggggggggggggggggggggggggggggggggggggggggggggggggggggggggggggggggggggggggggggggggggggggggggggggggggggggggggggffffffffffffffffffffffffffffffffffffffffffffffffffffffffffff
fggggggggggggggggggggggggggggggggggggggggggggggggggggggggggggggggggggggggggggggggggggggggggggggggggggggggggggggggggggggggggggffffffffffffffffffffffffffffffffffffffffffffffffffffffffffff
fggggggggggggggggggggggggggggggggggggggggggggggggggggggggggggggggggggggggggggggggggggggggggggggggggggggggggggggggggggggggggggffffffffffffffffffffffffffffffffffffffffffffffffffffffffffff
fggggggggggggggggggggggggggggggggggggggggggggggggggggggggggggggggggggggggggggggggggggggggggggggggggggggggggggggggggggggggggggffffffffffffffffffffffffffffffffffffffffffffffffffffffffffff
fggggggggggggggggggggggggggggggggggggggggggggggggggggggggggggggggggggggggggggggggggggggggggggggggggggggggggggggggggggggggggggffffffffffffffffffffffffffffffffffffffffffffffffffffffffffff
fggggggggggggggggggggggggggggggggggggggggggggggggggggggggggggggggggggggggggggggggggggggggggggggggggggggggggggggggggggggggggggffffffffffffffffffffffffffffffffffffffffffffffffffffffffffff
fggggggggggggggggggggggggggggggggggggggggggggggggggggggggggggggggggggggggggggggggggggggggggggggggggggggggggggggggggggggggggggffffffffffffffffffffffffffffffffffffffffffffffffffffffffffff
fggggggggggggggggggggggggggggggggggggggggggggggggggggggggggggggggggggggggggggggggggggggggggggggggggggggggggggggggggggggggggggffffffffffffffffffffffffffffffffffffffffffffffffffffffffffff
fffffffffffffffffffffffffffffffffffffffffffffffffffffffffffffffffffffffffffffffffffffffffffffffffffffffffffffffffffffffffffffffffffffffffffffffffffffffffffffffffffffffffffffffffffffffff
"}
