"a" = (/turf/open/openspace/norm,/area/maintenance/polovich/forest)
"b" = (/obj/structure/railing{dir = 8},/turf/open/floor/plating/polovich/way/muddy,/area/maintenance/polovich/forest)
"d" = (/obj/structure/railing{dir = 8},/turf/open/floor/plating/polovich/way/dirt,/area/maintenance/polovich/forest)
"g" = (/obj/structure/railing,/turf/open/floor/plating/polovich/way/muddy,/area/maintenance/polovich/forest)
"h" = (/turf/open/floor/plating/polovich/way/stone,/area/maintenance/polovich/forest)
"i" = (/turf/open/floor/plating/polovich/way/cavero,/area/maintenance/polovich/forest/cave)
"j" = (/turf/podpol/wall/caver,/area/maintenance/polovich/forest)
"k" = (/obj/structure/wayto/podpol,/turf/open/floor/plating/polovich/way/hotstone4,/area/maintenance/polovich/forest)
"l" = (/obj/structure/codec/bulb/green,/turf/open/floor/plating/polovich/way/nightbricks,/area/maintenance/polovich/forest)
"m" = (/obj/machinery/codec/door/kapno/father{autolock = 1; id_tag = "kapnodvor"},/turf/open/floor/plating/polovich/way/stone,/area/maintenance/polovich/forest)
"n" = (/obj/structure/codec/window/red,/turf/open/floor/plating/polovich/way/stoneold,/area/maintenance/polovich/forest)
"p" = (/turf/podpol/wall/steel,/area/maintenance/polovich/forest)
"r" = (/obj/structure/barbwire{dir = 8},/turf/open/floor/plating/polovich/way/dirt,/area/maintenance/polovich/forest)
"s" = (/turf/open/floor/plating/polovich/way/dirt,/area/maintenance/polovich/forest)
"t" = (/turf/podpol/wall/shroom,/area/maintenance/polovich/forest/cave)
"x" = (/turf/open/floor/plating/polovich/way/blackstoner2,/area/maintenance/polovich/forest)
"A" = (/turf/open/openspace/norm,/area/maintenance/polovich/forest/cave)
"B" = (/obj/structure/codec/bulb/green{dir = 1},/turf/open/floor/plating/polovich/way/nightbricks,/area/maintenance/polovich/forest)
"C" = (/turf/podpol/wall/shroom,/area/maintenance/polovich/forest)
"D" = (/turf/open/floor/plating/polovich/way/station/mystic/crazy/back,/area/maintenance/polovich/forest)
"F" = (/obj/structure/lighterfire,/turf/open/floor/plating/polovich/way/blackstoner2,/area/maintenance/polovich/forest)
"G" = (/turf/open/floor/plating/polovich/way/muddy,/area/maintenance/polovich/forest)
"K" = (/turf/podpol/wall/caver,/area/maintenance/polovich/forest/cave)
"L" = (/turf/open/floor/plating/polovich/way/nightbricks,/area/maintenance/polovich/forest)
"M" = (/turf/podpol/wall/darkyw,/area/maintenance/polovich/forest)
"N" = (/turf/open/floor/plating/polovich/way/stoneold,/area/maintenance/polovich/forest)
"O" = (/turf/podpol/wall/grewich,/area/maintenance/polovich/forest)
"P" = (/obj/structure/barbwire{dir = 8},/turf/open/floor/plating/polovich/way/muddy,/area/maintenance/polovich/forest)
"Q" = (/turf/open/floor/plating/polovich/way/cavero,/area/maintenance/polovich/forest)
"R" = (/obj/structure/codec/bulb/green{dir = 8},/turf/open/floor/plating/polovich/way/nightbricks,/area/maintenance/polovich/forest)
"T" = (/obj/structure/railing{dir = 1},/turf/open/floor/plating/polovich/way/muddy,/area/maintenance/polovich/forest)
"U" = (/obj/effect/decal/metalpodpol,/turf/open/floor/plating/polovich/way/dirt,/area/maintenance/polovich/forest)
"W" = (/turf/open/floor/plating/polovich/way/ravein,/area/maintenance/polovich/forest)
"X" = (/obj/structure/stairs/east,/turf/open/floor/plating/polovich/way/stone,/area/maintenance/polovich/forest)
"Y" = (/obj/effect/decal/metalpodpol,/turf/open/floor/plating/polovich/way/muddy,/area/maintenance/polovich/forest)
"Z" = (/obj/structure/sign/poster/contraband/codec/ring,/turf/podpol/wall/darkyw,/area/maintenance/polovich/forest)

(1,1,1) = {"
jjjjjjjjjjjjjjjjjjjjjjjjjjjjjjjjjjjjjjjjjjjjjjjjjjjjjjjjjjjjjjjjjjjjjjjjjjjjjjjjjjjjjjjjjjjjjjjjjjjjjjjjjjjjjjjjjjjjjjjj
jjjjjjjjjjjjjjjjjjjjjjjjjjjjjjjjjjjjjjjjjjjjjjjjjjjjjjjjjjjjjjjjjjjjjjjjjjjjjjjjjjjjjjjjjjjjjjjjjjjjjjjjjjjjjjjjjjjjjjjj
jjjjjjjjjjjjjjjjjjjjjjjjjjjjjjjjjjjjjjjjjjjjjjjjjjjjjjjjjjjjjjjjjjjjjjjjjjjjjjjjjjjjjjjjjjjjjjjjjjjjjjjjjjjjjjjjjjjjjjjj
jjjjjjjjjjjjjjjjjjjjjjjjjjjjjjjjjjjjjjjjjjjjjjjjjjjjjjjjjjjjjjjjjjjjjjjjjjjjjjjjjjjjjjjjjjjjjjjjjjjjjjjjjjjjjjjjjjjjjjjj
jjjjjjjjjjjjjjjjjjjjjjjjjjjjjjjjjjjjjjjjjjjjjjjjjjjjjjjjjjjjjjjjjjjjjjjjjjjjjjjjjjjjjjjjjjjjjjjjjjjjjjjjjjjjjjjjjjjjjjjj
jjjjjjjjjjjjjjjjjjjjjjjjjjjjjjjjjjjjjjjjjjjjjjjjjjjjjjjjjjjjjjjjjjjjjjjjjjjjjjjjjjjjjjjjjjjjjjjjjjjjjjjjjjjjjjjjjjjjjjjj
jjjjjjjjjjjjjjjjjjjjjjjjjjjjjjjjjjjjjjjjjjjjjjjjjjjjjjjjjjjjjjjjjjjjjjjjjjjjjjjjjjjjjjjjjjjjjjjjjjjjjjjjjjjjjjjjjjjjjjjj
jjjjjjjjjjjjjjjjjjjjjjjjjjjjjjjjjjjjjjjjjjjjjjjjjjjjjjjjjjjjjjjjjjjjjjjjjjjjjjjjjjjjjjjjjjjjjjjjjjjjjjjjjjjjjjjjjjjjjjjj
jjjjjjjjjjjjjjjjjjjjjjjjjjjjjjjjjjjjjjjjjjjjjjjjjjjjjjjjjjjjjjjjjjjjjjjjjjjjjjjjjjjjjjjjjjjjjjjjjjjjjjjjjjjjjjjjjjjjjjjj
jjjjjjjjjjjjjjjjjjjjjjjjjjjjjjjjjjjjjjjjjjjjjjjjjjjjjjjjjjjjjjjjjjjjjjjjjjjjjjjjjjjjjjjjjjjjjjjjjjjjjjjjjjjjjjjjjjjjjjjj
jjjjjjjjjjjjjjjjjjjjjjjjjjjjjjjjjjjjjjjjjjjjjjjjjjjjjjjjjjjjjjjjjjjjjjjjjjjjjjjjjjjjjjjjjjjjjjjjjjjjjjjjjjjjjjjjjjjjjjjj
jjjjjjjjjjjjjjjjjjjjjjjjjjjjjjjjjjjjjjjjjjjjjjjjjjjjjjjjjjjjjjjjjjjjjjjjjjjjjjjjjjjjjjjjjjjjjjjjjjjjjjjjjjjjjjjjjjjjjjjj
jjjjjjjjjjjjjjjjjjjjjjjjjjjjjjjjjjjjjjjjjjjjjjjjjjjjjjjjjjjjjjjjjjjjjjjjjjjjjjjjjjjjjjjjjjjjjjjjjjjjjjjjjjjjjjjjjjjjjjjj
jjjjjjjjjjjjjjjjjjjjjjjjjjjjjjjjjjjjjjjjjjjjjjjjjjjjjjjjjjjjjjjjjjjjjjjjjjjjjjjjjjjjjjjjjjjjjjjjjjjjjjjjjjjjjjjjjjjjjjjj
jjjjjjjjjjjjjjjjjjjjjjjjjjjjjjjjjjjjjjjjjjjjjjjjjjjjjjjjjjjjjjjjjjjjjjjjjjjjjjjjjjjjjjjjjjjjjjjjjjjjjjjjjjjjjjjjjjjjjjjj
jjjjjjjjjjjjjjjjjjjjjjjjjjjjjjjjjjjjjjjjjjjjjjjjjjjjjjjjjjjjjjjjjjjjjjjjjjjjjjjjjjjjjjjjjjjjjjjjjjjjjjjjjjjjjjjjjjjjjjjj
jjjjjjjjjjjjjjjjjjjjjjjjjjjjjjjjjjjjjjjjjjjjjjjjjjjjjjjjjjjjjjjjjjjjjjjjjjjjjjjjjjjjjjjjjjjjjjjjjjjjjjjjjjjjjjjjjjjjjjjj
jjjjjjjjjjjjjjjjjjjjjjjjjjjjjjjjjjjjjjjjjjjjjjjjjjjjjjjjjjjjjjjjjjjjjjjjjjjjjjjjjjjjjjjjjjjjjjjjjjjjjjjjjjjjjjjjjjjjjjjj
jjjjjjjjjjjjjjjjjjjjjjjjjjjjjjjjjjjjjjjjjjjjjjjjjjjjjjjjjjjjjjjjjjjjjjjjjjjjjjjjjjjjjjjjjjjjjjjjjjjjjjjjjjjjjjjjjjjjjjjj
jjjjjjjjjjjjjjjjjjjjjjjjjjjjjjjjjjjjjjjjjjjjjjjjjjjjjjjjjjjjjjjjjjjjjjjjjjjjjjjjjjjjjjjjjjjjjjjjjjjjjjjjjjjjjjjjjjjjjjjj
jjjjjjjjjjjjjjjjjjjjjjjjjjjjjjjjjjjjjjjjjjjjjjjjjjjjjjjjjjjjjjjjjjjjjjjjjjjjjjjjjjjjjjjjjjjjjjjjjjjjjjjjjjjjjjjjjjjjjjjj
jjjjjjjjjjjjjjjjjjjjjjjjjjjjjjjjjjjjjjjjjjjjjjjjjjjjjjjjjjjjjjjjjjjjjjjjjjjjjjjjjjjjjjjjjjjjjjjjjjjjjjjjjjjjjjjjjjjjjjjj
jjjjjjjjjjjjjjjjjjjjjjjjjjjjjjjjjjjjjjjjjjjjjjjjjjjjjjjjjjjjjjjjjjjjjjjjjjjjjjjjjjjjjjjjjjjjjjjjjjjjjjjjjjjjjjjjjjjjjjjj
jjjjjjjjjjjjjjjjjjjjjjjjjjjjjjjjjjjjjjjjjjjjjjjjjjjjjjjjjjjjjjjjjjjjjjjjjjjjjjjjjjjjjjjjjjjjjjjjjjjjjjjjjjjjjjjjjjjjjjjj
jjjjjjjjjjjjjjjjjjjjjjjjjjjjjjjjjjjjjjjjjjjjjjjjjjjjjjjjjjjjjjjjjjjjjjjjjjjjjjjjjjjjjjjjjjjjjjjjjjjjjjjjjjjjjjjjjjjjjjjj
jjjjjjjjjjjjjjjjjjjjjjjjjjjjjjjjjjjjjjjjjjjjjjjjjjjjjjjjjjjjjjjjjjjjjjjjjjjjjjjjjjjjjjjjjjjjjjjjjjjjjjjjjjjjjjjjjjjjjjjj
jjjjjjjjjjjjjjjjjjjjjjjjjjjjjjjjjjjjjjjjjjjjjjjjjjjjjjjjjjjjjjjjjjjjjjjjjjjjjjjjjjjjjjjjjjjjjjjjjjjjjjjjjjjjjjjjjjjjjjjj
jjjjjjjjjjjjjjjjjjjjjjjjjjjjjjjjjjjjjjjjjjjjjjjjjjjjjjjjjjjjjjjjjjjjjjjjjjjjjjjjjjjjjjjjjjjjjjjjjjjjjjjjjjjjjjjjjjjjjjjj
jjjjjjjjjjjjjjjjjjjjjjjjjjjjjjjjjjjjjjjjjjjjjjjjjjjjjjjjjjjjjjjjjjjjjjjjjjjjjjjjjjjjjjjjjjjjjjjjjjjjjjjjjjjjjjjjjjjjjjjj
jjjjjjjjjjjjjjjjjjjjjjjjjjjjjjjjjjjjjjjjjjjjjjjjjjjjjjjjjjjjjjjjjjjjjjjjjjjjjjjjjjjjjjjjjjjjjjjjjjjjjjjjjjjjjjjjjjjjjjjj
jjjjjjjjjjjjjjjjjjjjjjjjjjjjjjjjjjjjjjjjjjjjjjjjjjjjjjjjjjjjjjjjjjjjjjjjjjjjjjjjjjjjjjjjjjjjjjjjjjjjjjjjjjjjjjjjjjjjjjjj
jjjjjjjjjjjjjjjjjjjjjjjjjjjjjjjjjjjjjjjjjjjjjjjjjjjjjjjjjjjjjjjjjjjjjjjjjjjjjjjjjjjjjjjjjjjjjjjjjjjjjjjjjjjjjjjjjjjjjjjj
jjjjjjjjjjjjjjjjjjjjjjjjjjjjjjjjjjjjjjjjjjjjjjjjjjjjjjjjjjjjjjjjjjjjjjjjjjjjjjjjjjjjjjjjjjjjjjjjjjjjjjjjjjjjjjjjjjjjjjjj
jjjjjjjjjjjjjjjjjjjjjjjjjjjjjjjjjjjjjjjjjjjjjjjjjjjjjjjjjjjjjjjjjjjjjjjjjjjjjjjjjjjjjjjjjjjjjjjjjjjjjjjjjjjjjjjjjjjjjjjj
jjjjjjjjjjjjjjjjjjjjjjjjjjjjjjjjjjjjjjjjjjjjjjjjjjjjjjjjjjjjjjjjjjjjjjjjjjjjjjjjjjjjjjjjjjjjjjjjjjjjjjjjjjjjjjjjjjjjjjjj
jjjjjjjjjjjjjjjjjjjjjjjjjjjjjjjjjjjjjjjjjjjjjjjjjjjjjjjjjjjjjjjjjjjjjjjjjjjjjjjjjjjjjjjjjjjjjjjjjjjjjjjjjjjjjjjjjjjjjjjj
jjjjjjjjjjjjjjjjjjjjjjjjjjjjjjjjjjjjjjjjjjjjjjjjjjjjjjjjjjjjjjjjjjjjjjjjjjjjjjjjjjjjjjjjjjjjjjjjjjjjjjjjjjjjjjjjjjjjjjjj
jjjjjjjjjjjjjjjjjjjjjjjjjjjjjjjjjjjjjjjjjjjjjjjjjjjjjjjjjjjjjjjjjjjjjjjjjjjjjjjjjjjjjjjjjjjjjjjjjjjjjjjjjjjjjjjjjjjjjjjj
jjjjjjjjjjjjjjjjjjjjjjjjjjjjjjjjjjjjjjjjjjjjjjjjjjjjjjjjjjjjjjjjjjjjjjjjjjjjjjjjjjjjjjjjjjjjjjjjjjjjjjjjjjjjjjjjjjjjjjjj
jjjjjjjjjjjjjjjjjjjjjjjjjjjjjjjjjjjjjjjjjjjjjjjjjjjjjjjjjjjjjjjjjjjjjjjjjjjjjjjjjjjjjjjjjjjjjjjjjjjjjjjjjjjjjjjjjjjjjjjj
jjjjjjjjjjjjjjjjjjjjjjjjjjjjjjjjjjjjjjjjjjjjjjjjjjjjjjjjjjjjjjjjjjjjjjjjjjjjjjjjjjjjjjjjjjjjjjjjjjjjjjjjjjjjjjjjjjjjjjjj
jjjjjjjjjjjjjjjjjjjjjjjjjjjjjjjjjjjjjjjjjjjjjjjjjjjjjjjjjjjjjjjjjjjjjjjjjjjjjjjjjjjjjjjjjjjjjjjjjjjjjjjjjjjjjjjjjjjjjjjj
jjjjjjjjjjjjjjjjjjjjjjjjjjjjjjjjjjjjjjjjjjjjjjjjjjjjjjjjjjjjjjjjjjjjjjjjjjjjjjjjjjjjjjjjjjjjjjjjjjjjjjjjjjjjjjjjjjjjjjjj
jjjjjjjjjjjjjjjjjjjjjjjjjjjjjjjjjjjjjjjjjjjjjjjjjjjjjjjjjjjjjjjjjjjjjjjjjjjjjjjjjjjjjjjjjjjjjjjjjjjjjjjjjjjjjjjjjjjjjjjj
jjjjjjjjjjjjjjjjjjjjjjjjjjjjjjjjjjjjjjjjjjjjjjjjjjjjjjjjjjjjjjjjjjjjjjjjjjjjjjjjjjjjjjjjjjjjjjjjjjjjjjjjjjjjjjjjjjjjjjjj
jjjjjjjjjjjjjjjjjjjjjjjjjjjjjjjjjjjjjjjjjjjjjjjjjjjjjjjjjjjjjjjjjjjjjjjjjjjjjjjjjjjjjjjjjjjjjjjjjjjjjjjjjjjjjjjjjjjjjjjj
jjjjjjjjjjjjjjjjjjjjjjjjjjjjjjjjjjjjjjjjjjjjjjjjjjjjjjjjjjjjjjjjjjjjjjjjjjjjjjjjjjjjjjjjjjjjjjjjjjjjjjjjjjjjjjjjjjjjjjjj
jjjjjjjjjjjjjjjjjjjjjjjjjjjjjjjjjjjjjjjjjjjjjjjjjjjjjjjjjjjjjjjjjjjjjjjjjjjjjjjjjjjjjjjjjjjjjjjjjjjjjjjjjjjjjjjjjjjjjjjj
jjjjjjjjjjjjjjjjjjjjjjjjjjjjjjjjjjjjjjjjjjjjjjjjjjjjjjjjjjjjjjjjjjjjjjjjjjjjjjjjjjjjjjjjjjjjjjjjjjjjjjjjjjjjjjjjjjjjjjjj
jjjjjjjjjjjjjjjjjjjjjjjjjjjjjjjjjjjjjjjjjjjjjjjjjjjjjjjjjjjjjjjjjjjjjjjjjjjjjjjjjjjjjjjjjjjjjjjjjjjjjjjjjjjjjjjjjjjjjjjj
jjjjjjjjjjjjajjjjjjjjjjjjjjjjjjjjjjjjjjjjjjjjjjjjjjjjjjjjjjjjjjjjjjjjjjjjjjjjjjjjjjjjjjjjjjjjjjjjjjjjjjjjjjjjjjjjjjjjjjj
jjjjjjjjjjaaaaaajjjjjjjjjjjjjjjjjjjjjjjjjjjjjjjjjjjjjjjjjjjjjjjjjjjjjjjjjjjjjjjjjjjjjjjjjjjjjjjjjjjjjjjjjjjjjjjjjjjjjjjj
jjjjjjjjjaaaaaaaaaaaajajjjjjjjjjjjjjjjjjjjjjjjjjjjjjjjjjjjjjjjjjjjjjjjjjjjjjjjjjjjjjjjjjjjjjjjjjjjjjjjjjjjjjjjjjjjjjjjjj
jjjjjjaaaaaaaaaaaaaaaaaaajjjjjjjjjjjjjjjjjjjjjjjjjjjjjjjjjjjjjjjjjjjjjjjjjjjjjjjjjjjjjjjjjjjjjjjjjjjjjjjjjjjjjjjjjjjjjjj
jjjjjjaaaaaaaaaaaaaaaaaaaaaajjjjjjjjjjjjjjjjjjjjjjjjjjjjjjjjjjjjjjjjjjjjjjjjjjjjjjjjjjjjjjjjjjjjjjjjjjjjjjjjjjjjjjjjjjjj
jjjjjjjaaaaaaaaaaaaaaaaaaaaaajjjjjjjjjjjjjjjjjjjjjjjjjjjjjjjjjjjjjjjjjjjjjjjjjjjjjjjjjjjjjjjjjjjjjjjjjjjjjjjjjjjjjjjjjjj
jjppppjaaaaaaaaaaaaaaaaaaaaaajjjjjjjjjjjjjjjjjjjjjjjjjjjjjjjjjjjjjjjjjjjjjjjjjjjjjjjjjjjjjjjjjjjjjjjjjjjjjjjjjjjjjjjjjjj
jjOOOpjaaaaaaaaaaaaaaaaaaaaaaaajjjjjjjjjjjjjjjjjjjjjjjjjjjjjjjjjjjjjjjjjjjjjjjjjjjjjjjjjjjjjjjjjjjjjjjjjjjjjjjjjjjjjjjjj
OaaaOpjaaaaaaaaaaaaaaaaaaaaaaaaaaaajjjjjjjjjjjjjjjjjjjjjjjjjjjjjjjjjjjjjjjjjjjjjjjjjjjjjjjjjjjjjjjjjjjjjjjjjjjjjjjjjjjjj
OaaaOpjjaaaaaaaaaaaaaaaaaaaaaaaaaaaaajjjjjjjjjjjjjjjjjjjjjjjjjjjjjjjjjjjjjjjjjjjjjjjjjjjjjjjjjjjjjjjjjjjjjjjjjjjjjjjjjjj
OaaaOpjjaaaaaaaaaaaaaaaaaaaaaaaaaaaaaaaajjjjjjjjjjjjjjjjjjjjjjjjjjjjjjjjjjjjjjjjjjjjjjjjjjjjjjjjjjjjjjjjjjjjjjjjjjjjjjjj
OOaOOpjjjaaaaaaaaaaaaaaaaaaaaaaaaaaaaaaaajjjjjjjjjjjjjjjjjjjjjjjjjjjjjjjjjjjjjjjjjjjjjjjjjjjjjjjjjjjjjjjjjjjjjjjjjjjjjjj
ppajppjjjaaaaaaaaaaaaaaaaaaaaaaaaaaaaaaaaaaaaajjjjjjjjjjjjjjjjjjjjjjjjjjjjjjjjjjjjjjjjjjjjjjjjjjjjjjjjjjjjjjjjjjjjjjjjjj
jpajpjjjjjaaaaaaaaaaaaaaaaaaaaaaaaaaaaaaaaaaaaaajjjjjjjjjjjjjjjjjjjjjjjjjjjjjjjjjjjjjjjjjjjjjjjjjjjjjjjjjjjjjjjjjjjjjjjj
jpajpjjLjjjaaaaaaaaaaaaaaaaaaaaaaaaaaaaaaaaaaaaaaajjjjjjjjjjjjjjjjjjjjjjjjjjjjjjjjjjjjjjjjjjjjjjjjjjjjjjjjjjjjjjjjjjjjjj
jpajpBLLLBjjaaaaaaaaaaaaaaaaaaaaaaaaaaaaaaaaaaaaaaajjjjjjjjjjjjjjjjjjjjjjjjjjjjjjjjjjjjjjjjjjjjjjjjjjjjjjjjjjjjjjjjjjjjj
jpajpLLLLLjjjaaaaaaaaaaaaaaaaaaaaaaaaaaaaaaaaaaaaaaaajjjjjjjjjjjjjjjjjjjjjjjjjjjjjjjjjjjjjjjjjjjjjjjjjjjjjjjjjjjjjjjjjjj
OpappLOOOLLOOOOOaaaaaaaaaaaaaaaaaaaaaaaaaaaaaaaaaaaaaaajjjjjjjjjjjjjjjjjjjjjjjjjjjjjjjjjjjjjjjjjjjjjjjjjjjjjjjjjjjjjjjjj
OaaaOaOaORLLLxxxaaaaaaaaaaaaaaaaaaaaaaaaaaaaaaaaaaaaaaaaajjjjjjjjjjjjjjjjjjjjjjjjjjjjjjjjjjjjjjjjjjjjjjjjjjjjjjjjjjjjjjj
OaaaOaOaOLLLLxxFaaaaaaaaaaaaaaaaaaaaaaaaaaaaaaaaaaaaaaaaaajjjjjjjjjjjjjjjjjjjjjjjjjjjjjjjjjjjjjjjjjjjjjjjjjjjjjjjjjjjjjj
OaaaOaOaOLLlLxxxaaaaaaaaaaaaaaaaaaaaaaaaaaaaaaaaaaaaaaaaaaaajjjjjjjjjjjjjjjjjjjjjjjjjjjjjjjjjjjjjjjjjjjjjjjjjjjjjjjjjjjj
OaaaOOOaOOOOOxxxaaaaaaaaaaaaaaaaaaQaQaQaaaaaaaaaaaaaaaaaaaaaaajjjjjjjjjjjjjjjjjjjjjjjjjjjjjjjjjjjjjjjjjjjjjjjjjjjjjjjjjj
OaaaaaaaaaaOOxxxaaaaaaaaaaaaaaaaaaQaQaQaaaaaaaaaaaaaaaaaaaaaaaajjjjjjjjjjjjjjjjjjjjjjjjjjjjjjjjjjjjjjjjjjjjjjjjjjjjjjjjj
OaaaOaOOOOOOOxxxaaaaaaaaaaaaaaaaaaQaQaaaaaaaaaaaaaaaaaaaaaaaaajjjjjjjjjjjjjjjjjjjjjjjjjjjjjjjjjjjjjjjjjjjjjjjjjjjjjjjjjj
OaaaOaaaaaaaOxxxaaaaaaaaaaaaaaaaaaQaaaaaaaaaaaaaaaaaaaaaaaaaajjjjjjjjjjjjjjjjjjjjjjjjjjjjjjjjjjjjjjjjjjjjjjjjjjjjjjjjjjj
OaaaOaaaaaaaOxxFaaaaaaaaaaaaaaaaaaaaaaaaaaaaaaaaaaaaaaaaaaaajjjjjaaaajjjjjjjjjjjjjjjjjjjjjjjjjjjjjjjjjjjjjjjjjjjjjjjjjjj
OaaaOaaaaaaaOxxxaaaaaaaaaaaaaaaaaaaaaaaaaaaaaaaaaaaaaaaaaaajjjjjaaaaaaajjjjjjjjjjjjjjjjjjjjjjjjjjjjjjjjjjjjjjjjjjjjjjjjj
OpapOOOOOOOOOOOOaaaaaaaaaaaaaaaaaaaaaaaaaaaaaaaaaaaaaaaaaajjjjjaaaaaaaaaajjjjjjjjjjjjjjjjjjjjjjjjjjjjjjjjjjjjjjjjjjjjjjj
jpapjaaaaaaaaaaaaaaaaaaaaaaaaaaaaaaaaaaaaaaajjjjjjaaaaaaajjjjjjaaaaaaaaaaajjjjjjjjjjjjjjjjjjjjjjjjjjjjjjjjjjjjjjjjjjjjjj
jpapjaaaaaaaaaaaaaaaaaaaaaaaaaaaaaaaaaaaaaajjjjjjjjjjjajjjjjjjaaaaaaaaaaaajjjjjjjjjjjjjjjjjjjjjjjjjjjjjjjjjjjjjjjjjjjjjj
jpapjaaaaaaaaaaaaaaaaaaaaaaaaaaaaaaaaaaaaaaaaaaajjjjjjjjjjjjjaaaaaaaaaaaaajjjjjjjjjjjjjjjjjjjjjjjjjjjjjjjjjjjjjjjjjjjjjj
jpapjjjaaaaaaaaaaaaaaaaaaaaaaaaaaaaaaaaaaaaaaaaaajjjjjjjjjjjaaaaaaaaaaaaaajjjjjjjjjjjjjjjjjjjjjjjjjjjjjjjjjjjjjjjjjjjjjj
ppapppjaaaaaaaaaaaaaaaaaaaaaaaaaaaaaaaaaaaaaaaaaajjjjjjjjjjjaaaaaaaaaaaaaajjjjjjjjjjjjjjjjjjjjjjjjjjjjjjjjjjjjjjjjjjjjjj
OOaOOpjaaaaaaaaaaaaaaaaaaaaaaaaaaaaaaaaaaaaaaaaaQQQQQjjjjjjjaaaaaaaaaaaaaajjjjjjjjjjjjjjjjjjjjjjjjjjjjjjjjjjjjjjjjjjjjjj
OaaaOpjaaaaaaaaaaaaaaaaaaaaaaaaaaaaaaaaaaaaaaaaQQQQQQQQjjjjjaaaaaaaaaaaaaajjjjjjjjjjjjjjjjjjjjjjjjjjjjjjjjjjjjjjjjjjjjjj
OaaaOpjaaaaaaaaaaaaaaaaaaaaaaaaaaaaaaaCCaaaaaaQQQQaaaQQQjjjjjaaaaaaaaaaaaajjjjjjjjjjjjjjjjjjjjjjjjjjjjjjjjjjjjjjjjjjjjjj
OaaaOpjaaaaaaaaaaaaaaaaaaaaaaaaaaaaaaaaCCaaaajjQQQQQQQQQQjjjjaaaaaaaaaaaaajjjjjjjjjjjjjjjjjjjjjjjjjjjjjjjjjjjjjjjjjjjjjj
OOOOOpjaaaaaaaaaaaaaaaaaaaaaaaaaaaaaaaaCCCjjjjjQQQaaaQQQQjjajaaaaaaaaaaaaajjjjjjjjjjjjjjjjjjjjjjjjjjjjjjjjjjjjjjjjjjjjjj
ppppppjjaaaaaaaaaaaaaaaaaaaaaaaaaaaaaaaCtCCjjjjjQQQQQQQQaaaajaaaaaaaaaaaaajjjjjjjjjjjjjjjjjjjjjjjjjjjjjjjjjjjjjjjjjjjjjj
jjjjjjjjaaaaaaaaaaaaaaaaaaaaaaaaaaaaaaCtttttKjjjjQQQQQQaaaaajaaaaaaaaaaaaajjjjjjjjjjjjjjjjjjjjjjjjjjjjjjjjjjjjjjjjjjjjjj
jjjjjjjjaaaaaaaaaaaaaaaaaaaaaaaCQCCCCCCttttttCCjjjjjjjjaaaaajaaaaaaaaaaaaajjjjjjjjjjjjjjjjjjjjjjjjjjjjjjjjjjjjjjjjjjjjjj
jjjjjjjjaaaaaaaaaaaaaaaaaaaaaCttittttttttttttCCjjjjjjjjaaaaaaaaaaaaaaaaaaajjjjjjjjjjjjjjjjjjjjjjjjjjjjjjjjjjjjjjjjjjjjjj
jjjjjjjjjaaaaaaaaaaaaaaaaaaCCtttittttttttttttttCCjjjjjaaaaaaaaaaaaaaaaaaaajjjjjjjjjjjjjjjjjjjjjjjjjjjjjjjjjjjjjjjjjjjjjj
jjjjjjjjjaaaaaaaaaaaaaaaaaCCCtttAAAtttttttttttttCCjjjjaaaaaaaaaaaaaaaaaaaajjjjjjjjjjjjjjjjjjjjjjjjjjjjjjjjjjjjjjjjjjjjjj
jjjjjjjjjaaaaaaaaaaaaaaaaaaCCttAAAAAtttttttAttttCCCCCCCCaaaaaaaaQQaaaaaaaajjjjjjjjjjjjjjjjjjjjjjjjjjjjjjjjjjjjjjjjjjjjjj
jjjjjjjjjaaaaaaaaaaaaaaaaaaaCttAAAAAtttttttAAAAttttttttCaaaaaaaaQQaaaaaaaajjjGGGGjjjjjjjjjjjjjjjjjjjjjjjjjjjjjjjjjjjjjjj
jjjjjjjjjjaaaaaaaaaaaaaaaaaaCttAAAAAAttttttAAAAtAtAtAttCaaaaaaaaaaaaaaaaaajjjGGGGGGGGGGGGjjjjjjjjjjjjjjjjjjjjjjjjjjjjjjj
jjjjjjjjjjaaaaaaaaaaaaaaaaaCCttttAAAAAttttttAAAAAtAtAttCaaaaaaaaaaaQQaaaaajjGGGGGGGGGGGGGGGGGGGGGGjjjjjjjjjjjjjjjjjjjjjj
jjjjjjjjjaaaaaajjjaajaaaaaaCCttttAAAAAAtttAAAAAAAtAtAttCaaaaaaaaaaaQQaaaaajjGGGGGGGGGGGGGGGGGGGGGGGGGGGGGjjjjjjjjjjjjjjj
jjjjjjjjjaaaajjjjjjajjaaaaaCCtttttAAAAAAAtAAAAAAAAAtAttCCaaaaaaaaaaaaaaaaajjGGGGGGGGGGGGGGGGGGGGGGGGGGGGGGGjjjjjjjjjjjjj
jjjjjjjjjjjjjjjjjjjjjjjaaCCCCttttttAAAAAAAAAAAiAAAAAAtttCaaQQaaaaaaaaaaaaajGGGGGGGGGGGGGGGGGGGGGGGGGGGGGGjjjjjjjjjjjjjjj
jjjjjjjjjjjjjjjjjjjjjjjjaCtttttttttAAAAAAAAAAAiiiAAAAtttCaaQQaaaaaaaaaaaaajGGGGGGGGGGGGggggggggggggggggggMjjjjjjjjjjjjjj
aaaaaaaaaaaaaaaaaaaaaajjjCttttttttttAAAAAAAAAiiiAAAAAiiiQaaaaaaaaaaaaaaaaajGGGGGGGGGGGGGPGGPGGPbGGGGGGGGGMjjjjjjjjjjjjjj
aaaaaaaaaaaaaaaaaaaaaajjCCtttttttttttAAAAAAAAAAiAAAAttCCaaaaaaaQQaaaaaaaaajGGGGGGGGGGGGGPGGPGGPbGGssGGGGGMjjjjjjjjjjjjjj
aaaaaaaaaaaaaaaaaaaaaajjCCttttttttttttAAAAAAAAAAAAttttCaaaaaaaaQQaaaaaaaaNjGGGGGGGGGGGGGPGGPGGPbsssssGGGGMjjjjjjjjjjjjjj
aaaaaaaaaaaaaaaaaaaaaajKtttttttttttttttAAAAAAAAAAAttttCaaaaaaaaaaaaaaaaaaNjWGGGGGGGGGGGGPGGPGGPbssssssssGMjjjjjjjjjjjjjj
aaaaaaaaaaaaaaaaaaaaaajKttttttttttttttttAAAAAAAAttttttCaaaaaaaaaaaaaaaaaaNnWGGGGGGGGGGGGPGGPGGrdshhhhDhhsMjjjjjjjjjjjjjj
aaaaaaaaaaaaaaaaaaaaaajKtttttttttttttttttAAAAAAttCCCCCCaaaaaaaaaaaaaaaaaaNjWGGGGGGGGGGGGPGGPGsrdsWZsshsssMjjjjjjjjjjjjjj
aaaaaaaaaaaaaaaaaaaaaajKtttttttttttttttttttAAAtttCaaaaaaaaaaaaaaaaaaaaaaaaGGGGGGGGGGGGGsrssrssrMsWWWWhWWGMjjjjjjjjjjjjjj
aaaaaaaaaaaaaaaaaaaaaajKttttttttttttttttttttAAtCCaaaaaaaaaaaaaaaaaaaaaaaaaYYYYYYYYYYYUUUUUUssshmhhhhhkhWXMjjjjjjjjjjjjjj
aaaaaaaaaaaaaaaaaaaaaajKKttttttttttttttttttttttCaaaaaaaaaaaaaaaaaaaaaaaaaaGGGGGGGGGGGsssrssrssrMssssshWWGMjjjjjjjjjjjjjj
aaaaaaaaaaaaaaaaaaaaaajjjCCCCCCCCCCCtttttttttttCaaaaaaaaaaaaaaaaaaaaaaaaaNjWGGGGGGGGGGGsrssrssrdssGsshsGGMjjjjjjjjjjjjjj
aaaaaaaaaaaaaaaaaaaaaajjjjjCCCaaaaCCCaCCCCCCCCCaaaaaaaaaaaaaaaaaaaaaaaaaaNnWGGGGGGGGGGGTTTTTTTTMMMMMMMMMMMjjjjjjjjjjjjjj
aaaaaaaaaaaaaaaaaaaaaajjjjjjCCCaaaaaaaaaaaaaaaaaaaaaaaaaaaaaaaaaaaaaaaaaaNjWGGGGGGGGGGGGGGGGGGGGGGGGGGGGGjjjjjjjjjjjjjjj
aaaaaaaaaaaaaaaaaaaaaajjjjCCCaaaaaaaaaaaaaaaaaaaaaaaaaaaaaaaaaaaaaaaaaaaaNjGGGGGGGGGGGGGGGGGGGGGGGGGGGGGGjjjjjjjjjjjjjjj
aaaaaaaaaaaaaaaaaaaaaajjjCCaaaaaaaaaaaaaaaaaaaaaaaaaaaaaaaaaaaaaaaaaaaaaaajGGGGGGGGGGGGGGGGGGGGGGGGGGGGGjjjjjjjjjjjjjjjj
aaaaaaaaaaaaaaaaaaaaaajjCCCaaaaaaaaaaaaaaaaaaaaaaaaaaaaaaaaaaaaaaaaaaaaaaajjGGGGGGGGGGGGGGGGGGGGGGGGGGGGjjjjjjjjjjjjjjjj
aaaaaaaaaaaaaaaaaaaaaajjCCaaaaaaaaaaaaaaaaaaaaaaaaaaaaaaaaaaaaaaaaaaaaaaaajjjGGGGGGGGGGGGGGGGGGGGGGGGGjjjjjjjjjjjjjjjjjj
aaaaaaaaaaaaaaaaaaaaaajjjCaaaaaaaaaaaaaaaaaaaaaaaaaaaaaaaaaaaaaaaaaaaaaaaajjjjGGGGGGGGGGGGGGGGGGGGjjjjjjjjjjjjjjjjjjjjjj
aaaaaaaaaaaaaaaaaaaaaajjjCaaaaaaaaaaaaaaaaaaaaaaaaaaaaaaaaaaaaaaaaaaaaaaaajjjjGGGGGGGGGGGGGGGGjjjjjjjjjjjjjjjjjjjjjjjjjj
"}
