"aj" = (/obj/structure/medica,/turf/podpol/wall/steel,/area/maintenance/polovich/forest/inner)
"aW" = (/obj/structure/closet/crate,/obj/item/melee/hehe/pickaxe/iron,/obj/item/melee/hehe/pickaxe/iron,/obj/item/melee/hehe/pickaxe/iron,/obj/item/melee/hehe/pickaxe/iron,/turf/open/floor/carpet/purplee,/area/maintenance/polovich/forest/inner)
"bD" = (/obj/effect/decal/metalpodpol,/turf/open/floor/plating/polovich/way/for2,/area/maintenance/polovich/forest/can_ruin/fog)
"bQ" = (/obj/structure/railing,/turf/open/floor/plating/polovich/way/legend,/area/maintenance/polovich/forest/can_ruin)
"cb" = (/obj/structure/kaotikmachine,/turf/open/floor/plating/polovich/way/korvutic,/area/maintenance/polovich/forest/inner)
"cO" = (/obj/structure/codec/bulb/yellow{dir = 1},/turf/open/floor/carpet/purplee,/area/maintenance/polovich/forest/inner)
"dT" = (/obj/structure/closet/crate,/obj/structure/codec/bulb/green{dir = 1},/obj/item/podpol_weapon/spear/wooden,/obj/item/podpol_weapon/spear/wooden,/obj/item/podpol_weapon/spear/wooden,/obj/item/podpol_weapon/spear/wooden,/turf/open/floor/plating/polovich/way/korvutic,/area/maintenance/polovich/forest/inner)
"gv" = (/obj/structure/lighterfire,/turf/open/floor/plating/polovich/way/legend,/area/maintenance/polovich/forest/can_ruin)
"gL" = (/obj/structure/codec/bulb/yellow{dir = 4},/turf/open/floor/carpet/purplee,/area/maintenance/polovich/forest/inner)
"hf" = (/turf/open/floor/plating/polovich/way/exoticwood2,/area/maintenance/polovich/forest/can_ruin)
"hq" = (/turf/open/floor/plating/polovich/way/dirt,/area/maintenance/polovich/forest/can_ruin)
"jT" = (/turf/open/floor/plating/polovich/way/kaos/th,/area/maintenance/polovich/forest)
"kb" = (/obj/effect/landmark/start/new_player,/turf/open/openspace/norm,/area/maintenance/polovich/forest)
"lD" = (/turf/open/floor/plating/polovich/way/wisestone,/area/maintenance/polovich/forest/can_ruin/fog)
"lW" = (/obj/structure/kaos/blackwindow,/turf/open/floor/plating/polovich/way/kaos/fi,/area/maintenance/polovich/forest)
"mO" = (/obj/structure/closet/crate,/obj/item/podpol_weapon/sabre,/obj/item/podpol_weapon/sabre,/obj/item/podpol_weapon/sabre,/obj/item/podpol_weapon/sabre,/turf/open/floor/carpet/purplee,/area/maintenance/polovich/forest/inner)
"mR" = (/obj/effect/landing/kapno,/turf/open/floor/plating/polovich/way/korvutic,/area/maintenance/polovich/forest/inner)
"oe" = (/obj/structure/closet/crate,/obj/item/gun/ballistic/revolver/remis/nova,/obj/item/storage/box/a38,/turf/open/floor/plating/polovich/way/korvutic,/area/maintenance/polovich/forest/inner)
"qc" = (/obj/structure/closet/crate,/obj/item/gun/ballistic/shotgun/doublebarrel/bobox,/obj/item/storage/box/c12buckshot,/turf/open/floor/carpet/purplee,/area/maintenance/polovich/forest/inner)
"qU" = (/obj/structure/closet/crate,/obj/item/flashlight/flare,/obj/item/flashlight/flare,/obj/item/flashlight/flare,/obj/item/flashlight/flare,/turf/open/floor/plating/polovich/way/korvutic,/area/maintenance/polovich/forest/inner)
"qV" = (/obj/structure/closet/crate,/obj/item/flashlight/flare,/obj/item/flashlight/flare,/obj/item/flashlight/flare,/obj/item/flashlight/flare,/turf/open/floor/carpet/purplee,/area/maintenance/polovich/forest/inner)
"rn" = (/obj/structure/medica,/turf/podpol/wall/darkyw,/area/maintenance/polovich/forest/inner)
"uN" = (/obj/structure/stairs/south,/turf/open/floor/carpet/purplee,/area/maintenance/polovich/forest/inner)
"vj" = (/turf/podpol/wall/grewich,/area/maintenance/polovich/forest/inner)
"vw" = (/obj/structure/blockrole{allow_role = "Kapnobatai"},/obj/machinery/codec/door/kapno,/turf/open/floor/plating/polovich/way/exoticwood2,/area/maintenance/polovich/forest/inner)
"wq" = (/turf/open/floor/plating/polovich/way/kaos,/area/maintenance/polovich/forest)
"wQ" = (/turf/podpol/wall/caverak,/area/maintenance/polovich/forest/cave/can_ruin)
"xd" = (/obj/structure/railing{dir = 4},/turf/open/floor/plating/polovich/way/legend,/area/maintenance/polovich/forest/can_ruin)
"yY" = (/obj/effect/landing/konch,/turf/open/floor/carpet/purplee,/area/maintenance/polovich/forest/inner)
"ze" = (/obj/structure/kaotikmachine,/turf/open/floor/carpet/purplee,/area/maintenance/polovich/forest/inner)
"zl" = (/turf/podpol/wall/steel,/area/maintenance/polovich/forest)
"AK" = (/turf/podpol/wall/darkyw,/area/maintenance/polovich/forest/inner)
"BX" = (/turf/podpol/wall/caver,/area/maintenance/polovich/forest/can_ruin)
"Cc" = (/obj/effect/decal/metalpodpol,/obj/effect/decal/metalpodpol,/turf/open/floor/plating/polovich/way/for2,/area/maintenance/polovich/forest/can_ruin/fog)
"Cw" = (/turf/open/floor/plating/polovich/way/kaos/fi,/area/maintenance/polovich/forest)
"DS" = (/turf/podpol/wall/steel,/area/maintenance/polovich/forest/can_ruin)
"DY" = (/obj/structure/blockrole{allow_role = "Kapnobatai"},/turf/open/floor/plating/polovich/way/exoticwood2,/area/maintenance/polovich/forest/can_ruin)
"EF" = (/obj/structure/blockrole/konch,/turf/open/floor/plating/polovich/way/dirt,/area/maintenance/polovich/forest/can_ruin)
"Fv" = (/turf/open/floor/plating/polovich/way/goldenwise,/area/maintenance/polovich/forest/can_ruin/fog)
"FE" = (/turf/open/floor/plating/polovich/way/korvutic,/area/maintenance/polovich/forest/inner)
"HK" = (/obj/structure/railing{dir = 8},/turf/open/floor/plating/polovich/way/legend,/area/maintenance/polovich/forest/can_ruin)
"Ip" = (/obj/structure/blockrole/konch,/obj/machinery/codec/door/konch,/turf/open/floor/carpet/purplee,/area/maintenance/polovich/forest/inner)
"Jb" = (/obj/structure/kaos/blackwindow,/turf/open/floor/plating/polovich/way/kaos/th,/area/maintenance/polovich/forest)
"Jp" = (/turf/open/floor/plating/polovich/way/legend,/area/maintenance/polovich/forest/can_ruin)
"Ku" = (/obj/structure/closet/crate,/obj/item/melee/hehe/pickaxe/iron,/obj/item/melee/hehe/pickaxe/iron,/obj/item/melee/hehe/pickaxe/iron,/obj/item/melee/hehe/pickaxe/iron,/turf/open/floor/plating/polovich/way/korvutic,/area/maintenance/polovich/forest/inner)
"KQ" = (/turf/open/openspace/norm,/area/maintenance/polovich/forest/can_ruin/fog)
"Ld" = (/obj/structure/codec/bulb/yellow,/turf/open/floor/carpet/purplee,/area/maintenance/polovich/forest/inner)
"Mn" = (/turf/open/floor/plating/polovich/way/hotstone4,/area/maintenance/polovich/forest/can_ruin/fog)
"Nk" = (/turf/open/floor/plating/polovich/way/for2,/area/maintenance/polovich/forest/can_ruin/fog)
"Np" = (/turf/open/openspace/norm,/area/maintenance/polovich/forest/can_ruin)
"OY" = (/obj/structure/blockrole/konch,/turf/open/floor/plating/polovich/way/legend,/area/maintenance/polovich/forest/can_ruin)
"PA" = (/obj/structure/blockrole/konch,/turf/open/floor/plating/polovich/way/dirt,/area/maintenance/polovich/forest/inner)
"Rw" = (/obj/structure/lighterfire,/turf/open/floor/plating/polovich/way/for2,/area/maintenance/polovich/forest/can_ruin/fog)
"RN" = (/obj/structure/blockrole/konch,/turf/open/floor/plating/polovich/way/hotstone4,/area/maintenance/polovich/forest/inner)
"Sd" = (/turf/open/floor/plating/polovich/way/dirt,/area/maintenance/polovich/forest/can_ruin/fog)
"Sl" = (/turf/open/floor/carpet/purplee,/area/maintenance/polovich/forest/inner)
"St" = (/obj/structure/codec/bulb/green{dir = 1},/turf/open/floor/plating/polovich/way/korvutic,/area/maintenance/polovich/forest/inner)
"SO" = (/obj/structure/codec/bulb/green{dir = 4},/turf/open/floor/plating/polovich/way/korvutic,/area/maintenance/polovich/forest/inner)
"TL" = (/obj/structure/codec/bulb/yellow{dir = 8},/turf/open/floor/carpet/purplee,/area/maintenance/polovich/forest/inner)
"UJ" = (/obj/structure/codec/bulb/green,/turf/open/floor/plating/polovich/way/korvutic,/area/maintenance/polovich/forest/inner)
"Vq" = (/turf/open/floor/plating/polovich/way/kaos/ei,/area/maintenance/polovich/forest)
"WP" = (/turf/open/floor/plating/polovich/way/kaos/ni,/area/maintenance/polovich/forest)
"Yw" = (/turf/podpol/wall/steel,/area/maintenance/polovich/forest/inner)
"Zd" = (/obj/structure/blockrole{allow_role = "Kapnobatai"},/turf/open/floor/plating/polovich/way/korvutic,/area/maintenance/polovich/forest/inner)

(1,1,1) = {"
wQwQwQwQwQwQwQwQwQwQwQwQwQwQwQwQwQwQwQwQwQwQwQwQwQwQwQwQwQwQwQwQwQwQwQwQwQwQwQwQwQwQwQwQwQwQwQwQwQwQwQwQwQwQwQwQwQwQwQwQ
wQwQwQwQwQwQwQwQwQwQwQwQwQwQwQwQwQwQwQwQwQwQwQwQwQwQwQwQwQwQwQwQwQwQwQwQwQwQwQwQwQwQwQwQwQwQwQwQwQwQwQwQwQwQwQwQwQwQwQwQ
wQwQwQwQwQwQwQwQwQwQwQwQwQwQwQwQwQwQwQwQwQwQwQwQwQwQwQwQwQwQwQwQwQwQwQwQwQwQwQwQwQwQwQwQwQwQwQwQwQwQwQwQwQwQwQwQwQwQwQwQ
wQwQwQwQwQwQwQwQwQwQwQwQwQwQwQwQwQwQwQwQwQwQwQwQwQwQwQwQwQwQwQwQwQwQwQwQwQwQwQwQwQwQwQwQwQwQwQwQwQwQwQwQwQwQwQwQwQwQwQwQ
wQwQwQwQwQwQwQwQwQwQwQwQwQwQwQwQwQwQwQwQwQwQwQwQwQwQwQwQwQwQwQwQwQwQwQwQwQwQwQwQwQwQwQwQwQwQwQwQwQwQwQwQwQwQwQwQwQwQwQwQ
wQwQwQwQwQwQwQwQwQwQwQwQwQwQwQwQwQwQwQwQwQwQwQwQwQwQwQwQwQwQwQwQwQwQwQwQwQwQwQwQwQwQwQwQwQwQwQwQwQwQwQwQwQwQwQwQwQwQwQwQ
wQwQwQwQwQwQwQwQwQwQwQwQwQwQwQwQwQwQwQwQwQwQwQwQwQwQwQwQwQwQwQwQwQwQwQwQwQwQwQwQwQwQwQwQwQwQwQwQwQwQwQwQwQwQwQwQwQwQwQwQ
wQwQwQwQwQwQwQwQwQwQwQwQwQwQwQwQwQwQwQwQwQwQwQwQwQwQwQwQwQwQwQwQwQwQwQwQwQwQwQwQwQwQwQwQwQwQwQwQwQwQwQwQwQwQwQwQwQwQwQwQ
wQwQwQwQwQwQwQwQwQwQwQwQwQwQwQwQwQwQwQwQwQwQwQwQwQwQwQwQwQwQwQwQwQwQwQwQwQwQwQwQwQwQwQwQwQwQwQwQwQwQwQwQwQwQwQwQwQwQwQwQ
wQwQwQwQwQwQwQwQwQwQwQwQwQwQwQwQwQwQwQwQwQwQwQwQwQwQwQwQwQwQwQwQwQwQwQwQwQwQwQwQwQwQwQwQwQwQwQwQwQwQwQwQwQwQwQwQwQwQwQwQ
wQwQwQwQwQwQwQwQwQwQwQwQwQwQwQwQwQwQwQwQwQwQwQwQwQwQwQwQwQwQwQwQwQwQwQwQwQwQwQwQwQwQwQwQwQwQwQwQwQwQwQwQwQwQwQwQwQwQwQwQ
wQwQwQwQwQwQwQwQwQwQwQwQwQwQwQwQwQwQwQwQwQwQwQwQwQwQwQwQwQwQwQwQwQwQwQwQwQwQwQwQwQwQwQwQwQwQwQwQwQwQwQwQwQwQwQwQwQwQwQwQ
wQwQwQwQwQwQwQwQwQwQwQwQwQwQwQwQwQwQwQwQwQwQwQwQwQwQwQwQwQwQwQwQwQwQwQwQwQwQwQwQwQwQwQwQwQwQwQwQwQwQwQwQwQwQwQwQwQwQwQwQ
wQwQwQwQwQwQwQwQwQwQwQwQwQwQwQwQwQwQwQwQwQwQwQwQwQwQwQwQwQwQwQwQwQwQwQwQwQwQwQwQwQwQwQwQwQwQwQwQwQwQwQwQwQwQwQwQwQwQwQwQ
wQwQwQwQwQwQwQwQwQwQwQwQwQwQwQwQwQwQwQwQwQwQwQwQwQwQwQwQwQwQwQwQwQwQwQwQwQwQwQwQwQwQwQwQwQwQwQwQwQwQwQwQwQwQwQwQwQwQwQwQ
wQwQwQwQwQwQwQwQwQwQwQwQwQwQwQwQwQwQwQwQwQwQwQwQwQwQwQwQwQwQwQwQwQwQwQwQwQwQwQwQwQwQwQwQwQwQwQwQwQwQwQwQwQwQwQwQwQwQwQwQ
wQwQwQwQwQwQwQwQwQwQwQwQwQwQwQwQwQwQwQwQwQwQwQwQwQwQwQwQwQwQwQwQwQwQwQwQwQwQwQwQwQwQwQwQwQwQwQwQwQwQwQwQwQwQwQwQwQwQwQwQ
wQwQwQwQwQwQwQwQwQwQwQwQwQwQwQwQwQwQwQwQwQwQwQwQwQwQwQwQwQwQwQwQwQwQwQwQwQwQwQwQwQwQwQwQwQwQwQwQwQwQwQwQwQwQwQwQwQwQwQwQ
wQwQwQwQwQwQwQwQwQwQwQwQwQwQwQwQwQwQwQwQwQwQwQwQwQwQwQwQwQwQwQwQwQwQwQwQwQwQwQwQwQwQwQwQwQwQwQwQwQwQwQwQwQwQwQwQwQwQwQwQ
wQwQwQwQwQwQwQwQwQwQwQwQwQwQwQwQwQwQwQwQwQwQwQwQwQwQwQwQwQwQwQwQwQwQwQwQwQwQwQwQwQwQwQwQwQwQwQwQwQwQwQwQwQwQwQwQwQwQwQwQ
wQwQwQwQwQwQwQwQwQwQwQwQwQwQwQwQwQwQwQwQwQwQwQwQwQwQwQwQwQwQwQwQwQwQwQwQwQwQwQwQwQwQwQwQwQwQwQwQwQwQwQwQwQwQwQwQwQwQwQwQ
wQwQwQwQwQwQwQwQwQwQwQwQwQwQwQwQwQwQwQwQwQwQwQwQwQwQwQwQwQwQwQwQwQwQwQwQwQwQwQwQwQwQwQwQwQwQwQwQwQwQwQwQwQwQwQwQwQwQwQwQ
wQwQwQwQwQwQwQwQwQwQwQwQwQwQwQwQwQwQwQwQwQwQwQwQwQwQwQwQwQwQwQwQwQwQwQwQwQwQwQwQwQwQwQwQwQwQwQwQwQwQwQwQwQwQwQwQwQwQwQwQ
wQwQwQwQwQwQwQwQwQwQwQwQwQwQwQwQwQwQwQwQwQwQwQwQwQwQwQwQwQwQwQwQwQwQwQwQwQwQwQwQwQwQwQwQwQwQwQwQwQwQwQwQwQwQwQwQwQwQwQwQ
wQwQwQwQwQwQwQwQwQwQwQwQwQwQwQwQwQwQwQwQwQwQwQwQwQwQwQwQwQwQwQwQwQwQwQwQwQwQwQwQwQwQwQwQwQwQwQwQwQwQwQwQwQwQwQwQwQwQwQwQ
wQwQwQwQwQwQwQwQwQwQwQwQwQwQwQwQwQwQwQwQwQwQwQwQwQwQwQwQwQwQwQwQwQwQwQwQwQwQwQwQwQwQwQwQwQwQwQwQwQwQwQwQwQwQwQwQwQwQwQwQ
wQwQwQwQwQwQwQwQwQwQwQwQwQwQwQwQwQwQwQwQwQwQwQwQwQwQwQwQwQwQwQwQwQwQwQwQwQwQwQwQwQwQwQwQwQwQwQwQwQwQwQwQwQwQwQwQwQwQwQwQ
wQwQwQwQwQwQwQwQwQwQwQwQwQwQwQwQwQwQwQwQwQwQwQwQwQwQwQwQwQwQwQwQwQwQwQwQwQwQwQwQwQwQwQwQwQwQwQwQwQwQwQwQwQwQwQwQwQwQwQwQ
wQwQwQwQwQwQwQwQwQwQwQwQwQwQwQwQwQwQwQwQwQwQwQwQwQwQwQwQwQwQwQwQwQwQwQwQwQwQwQwQwQwQwQwQwQwQwQwQwQwQwQwQwQwQwQwQwQwQwQwQ
wQwQwQwQwQwQwQwQwQwQwQwQwQwQwQwQwQwQwQwQwQwQwQwQwQwQwQwQwQwQwQwQwQwQwQwQwQwQwQwQwQwQwQwQwQwQwQwQwQwQwQwQwQwQwQwQwQwQwQwQ
wQwQwQwQwQwQwQwQwQwQwQwQwQwQwQwQwQwQwQwQwQwQwQwQwQwQwQwQwQwQwQwQwQwQwQwQwQwQwQwQwQwQwQwQwQwQwQwQwQwQwQwQwQwQwQwQwQwQwQwQ
wQwQwQwQwQwQwQwQwQwQwQwQwQwQwQwQwQwQwQwQwQwQwQwQwQwQwQwQwQwQwQwQwQwQwQwQwQwQwQwQwQwQwQwQwQwQwQwQwQwQwQwQwQwQwQwQwQwQwQwQ
wQwQwQwQwQwQwQwQwQwQwQwQwQwQwQwQwQwQwQwQwQwQwQwQwQwQwQwQwQwQwQwQwQwQwQwQwQwQwQwQwQwQwQwQwQwQwQwQwQwQwQwQwQwQwQwQwQwQwQwQ
wQwQwQwQwQwQwQwQwQwQwQwQwQwQwQwQwQwQwQwQwQwQwQwQwQwQwQwQwQwQwQwQwQwQwQwQwQwQwQwQwQwQwQwQwQwQwQwQwQwQwQwQwQwQwQwQwQwQwQwQ
wQwQwQwQwQwQwQwQwQwQwQwQwQwQwQwQwQwQwQwQwQwQwQwQwQwQwQwQwQwQwQwQwQwQwQwQwQwQwQwQwQwQwQwQwQwQwQwQwQwQwQwQwQwQwQwQwQwQwQwQ
wQwQwQwQwQwQwQwQwQwQwQwQwQwQwQwQwQwQwQwQwQwQwQwQwQwQwQwQwQwQwQwQwQwQwQwQwQwQwQwQwQwQwQwQwQwQwQwQwQwQwQwQwQwQwQwQwQwQwQwQ
wQwQwQwQwQwQwQwQwQwQwQwQwQwQwQwQwQwQwQwQwQwQwQwQwQwQwQwQwQwQwQwQwQwQwQwQwQwQwQwQwQwQwQwQwQwQwQwQwQwQwQwQwQwQwQwQwQwQwQwQ
wQwQwQwQwQwQwQwQwQwQwQwQwQwQwQwQwQwQwQwQwQwQwQwQwQwQwQwQwQwQwQwQwQwQwQwQwQwQwQwQwQwQwQwQwQwQwQwQwQwQwQwQwQwQwQwQwQwQwQwQ
wQwQwQwQwQwQwQwQwQwQwQwQwQwQwQwQwQwQwQwQwQwQwQwQwQwQwQwQwQwQwQwQwQwQwQwQwQwQwQwQwQwQwQwQwQwQwQwQwQwQwQwQwQwQwQwQwQwQwQwQ
wQwQwQwQwQwQwQwQwQwQwQwQwQwQwQwQwQwQwQwQwQwQwQwQwQwQwQwQwQwQwQwQwQwQwQwQwQwQwQwQwQwQwQwQwQwQwQwQwQwQwQwQwQwQwQwQwQwQwQwQ
wQwQwQwQwQwQwQwQwQwQwQwQwQwQwQwQwQwQwQwQwQwQwQwQwQwQwQwQwQwQwQwQwQwQwQwQwQwQwQwQwQwQwQwQwQwQwQwQwQwQwQwQwQwQwQwQwQwQwQwQ
wQwQwQwQwQwQwQwQwQwQwQwQwQwQwQwQwQwQwQwQwQwQwQwQwQwQwQwQwQwQwQwQwQwQwQwQwQwQwQwQwQwQwQwQwQwQwQwQwQwQwQwQwQwQwQwQwQwQwQwQ
wQwQwQwQwQwQwQwQwQwQwQwQwQwQwQwQwQwQwQwQwQwQwQwQwQwQwQwQwQwQwQwQwQwQwQwQwQwQwQwQwQwQwQwQwQwQwQwQwQwQwQwQwQwQwQwQwQwQwQwQ
zlzlzlzlzlzlzlzlzlzlzlzlzlzlzlzlzlzlzlzlzlzlzlwQwQwQwQwQwQwQwQwQwQwQwQwQwQwQwQwQwQwQwQwQwQwQwQwQwQwQwQwQwQwQwQwQwQwQwQwQ
lWjTCwJbCwCwCwCwJbCwCwjTCwCwJbCwCwCwJbCwjTlWzlwQwQwQwQwQwQwQwQwQwQwQwQwQwQwQwQwQwQwQwQwQwQwQwQwQwQwQwQwQwQwQwQwQwQwQwQwQ
CwjTwqjTwqwqwqwqjTwqwqwqwqwqjTwqwqwqjTwqjTCwzlwQwQwQwQwQwQwQwQwQwQwQwQwQwQwQwQwQwQwQwQwQwQwQwQwQwQwQwQwQwQwQwQwQwQwQwQwQ
CwjTwqjTwqwqwqwqwqwqwqwqwqwqwqwqwqwqjTwqjTCwzlwQwQwQwQwQwQwQwQwQwQwQwQwQwQwQwQwQwQwQwQwQwQwQwQwQwQwQwQwQwQwQwQwQwQwQwQwQ
CwjTwqjTwqwqwqVqVqVqWPCwWPVqVqVqwqwqjTwqjTCwzlwQwQwQwQwQwQwQwQwQwQwQwQwQwQwQwQwQwQwQwQwQwQwQwQwQwQwQwQwQwQwQwQwQwQwQwQwQ
CwwqwqjTwqwqwqVqlWVqWPCwWPVqlWVqwqwqjTwqwqCwzlwQwQwQwQwQwQwQwQwQwQwQwQwQwQwQwQwQwQwQwQwQwQwQwQwQwQwQwQwQwQwQwQwQwQwQwQwQ
CwwqwqjTwqwqwqVqVqCwWPlWWPCwVqVqwqwqjTwqwqCwzlwQwQwQwQwQwQwQwQwQwQwQwQwQwQwQwQwQwQwQwQwQwQwQwQwQwQwQwQwQwQwQwQwQwQwQwQwQ
CwwqwqjTwqwqwqWPWPWPCwCwCwWPWPWPwqwqjTwqwqCwzlwQwQwQwQwQwQwQwQwQwQwQwQwQwQwQwQwQwQwQwQwQwQwQwQwQwQwQwQwQwQwQwQwQwQwQwQwQ
CwwqwqjTwqwqwqCwCwlWCwkbCwlWCwCwwqwqjTwqwqCwzlwQwQwQwQwQwQwQwQwQwQwQwQwQwQwQwQwQwQwQwQwQwQwQwQwQwQwQwQwQwQwQwQwQwQwQwQwQ
CwwqwqjTwqwqwqWPWPWPCwCwCwWPWPWPwqwqjTwqwqCwzlwQwQwQwQwQwQwQwQwQwQwQwQwQwQwQwQwQwQwQwQwQwQwQwQwQwQwQwQwQwQwQwQwQwQwQwQwQ
CwwqwqjTwqwqwqVqVqCwWPlWWPCwVqVqwqwqjTwqwqCwzlwQwQwQwQwQwQwQwQwQwQwQwQwQwQwQwQwQwQwQwQwQwQwQwQwQwQwQwQwQwQwQwQwQwQwQwQwQ
CwwqwqjTwqwqwqVqlWVqWPCwWPVqlWVqwqwqjTwqwqCwzlwQwQwQwQwQwQwQwQwQwQwQwQwQwQwQwQwQwQwQwQwQwQwQwQwQwQwQwQwQwQwQwQwQwQwQwQwQ
CwwqwqjTwqwqwqVqVqVqWPCwWPVqVqVqwqwqjTwqwqCwzlwQwQwQwQwQwQwQwQwQwQwQwQwQwQwQwQwQwQwQwQwQwQwQwQwQwQwQwQwQwQwQwQwQwQwQwQwQ
CwwqwqjTwqwqwqwqwqwqwqwqwqwqwqwqwqwqjTwqwqCwzlwQwQwQwQwQwQwQwQwQwQwQwQwQwQwQwQwQwQwQwQwQwQwQwQwQwQwQwQwQwQwQwQwQwQwQwQwQ
CwwqwqjTwqwqwqwqjTwqwqwqwqwqjTwqwqwqjTwqwqCwzlwQwQwQwQwQwQwQwQwQwQwQwQwQwQwQwQwQwQwQwQwQwQwQwQwQwQwQwQwQwQwQwQwQwQwQwQwQ
CwwqwqjTwqwqwqwqjTwqwqjTwqwqjTwqwqwqjTwqwqCwzlwQwQwQwQwQwQwQwQwQwQwQwQwQwQwQwQwQwQwQwQwQwQwQwQwQwQwQwQwQwQwQwQwQwQwQwQwQ
lWCwCwJbCwCwCwCwJbCwCwjTCwCwJbCwCwCwJbCwCwlWzlwQwQwQwQwQwQwQwQwQwQwQwQwQwQwQwQwQwQwQwQwQwQwQwQwQwQwQwQwQwQwQwQwQwQwQwQwQ
"}
(1,1,2) = {"
BXBXBXBXBXBXBXBXBXBXBXBXBXvjvjvjvjvjvjvjYwYwYwYwajYwYwYwYwYwajYwYwYwYwvjvjvjvjvjBXBXBXBXBXBXBXBXBXBXBXBXBXBXBXBXBXBXBXBX
BXBXhqhqhqhqhqhqhqhqhqhqhqPASlSlSlcOSlSlYwSlSlcOSlSlSlcOSlSlSlcOSlSlYwSlSlSlvjvjBXBXBXBXBXBXBXBXBXBXBXBXBXBXBXBXBXBXBXBX
BXBXhqBXBXBXBXBXBXBXhqBXBXvjSlSlSlSlSlSlIpSlSlSlSlSlSlyYSlSlSlSlSlSlYwSlSlgLvjvjBXBXBXBXBXBXBXBXBXBXBXBXBXBXBXBXBXBXBXBX
BXBXhqBXBXBXBXBXBXBXEFBXBXvjTLSlSlSlSlSlYwSlSlSlSlSlSlSlSlSlSlSlSlSlIpSlSlSlvjvjBXBXNkNkNkNkNkNkNkNkNkNkNkNkNkBXBXBXBXBX
BXBXhqBXBXNkNkNkNkNkNkNkBXvjSlaWmOqVqcSlYwSlSlSlSlSlSlSlSlSlSlSlSlSlYwSlSlSlvjvjBXNkNkNkNkNkNkNkNkNkNkNkNkNkNkBXBXBXBXBX
BXBXhqEFNkNkNkNkNkNkNkNkBXvjvjvjvjvjvjvjYwSlSlSlSlSlSluNSlSlSlSlSlSlYwSlSlgLvjvjNkNkNkNkNkNkNkNkNkNkNkNkNkNkNkBXBXBXBXBX
BXBXBXBXNkNkNkNkNkNkNkNkBXBXBXBXBXBXBXBXYwSlSlLdzeSlSlvjSlSlzeLdSlSlYwSlSlSlvjvjNkNkNkNkNkNkNkNkNkNkNkNkNkNkNkBXBXBXBXBX
BXBXBXBXBXNkNkNkNkNkNkNkNkNkBXBXBXBXBXBXYwYwYwYwYwYwYwYwYwYwYwYwYwYwYwvjRNRNvjvjNkNkNkNkNkNkNkNkNkNkNkNkNkNkNkBXBXBXBXBX
BXBXBXBXBXNkNkNkNkNkNkNkNkNkNkNkNkNkNkNkNkNkNkNkNkNkNkNkNkNkNkNkNkNkNkMnMnMnMnNkNkNkNkNkNkNkNkNkNkNkNkNkNkNkNkBXBXBXBXBX
BXBXBXBXBXNkNkNkNkNkNkNkNkNkNkNkNkNkNkNkNkNkNkNkNkNkNkNkNkNkNkNkNkNkNkMnMnMnMnNkNkNkNkNkNkNkNkNkNkNkNkNkNkNkNkBXBXBXBXBX
BXBXBXBXBXNkNkNkNkNkNkNkNkNkNkNkNkNkNkNkNkNkNkNkNkNkNkNkNkNkNkNkNkNkNkNkbDNkNkNkNkNkNkNkNkNkNkNkNkNkNkNkNkNkNkBXBXBXBXBX
BXBXBXBXNkNkNkNkNkNkNkNkNkNkNkNkNkNkNkNkNkNkNkNkNkNkNkNkNkNkNkNkNkNkNkbDNkNkNkNkNkNkNkNkNkNkNkNkNkNkNkNkNkNkNkBXBXBXBXBX
BXBXBXBXNkNkNkNkNkNkNkNkNkNkNkNkNkNkNkNkNkNkNkNkNkNkNkNkNkNkNkNkNkNkbDNkNkNkNkNkNkNkNkNkNkNkNkNkNkNkNkNkNkNkNkBXBXBXBXBX
BXBXBXBXNkNkNkNkNkNkNkNkNkNkNkNkNkNkNkNkNkNkNkNkNkNkNkNkNkNkNkNkNkbDNkNkNkNkNkNkNkNkNkNkNkNkNkNkNkNkNkNkNkNkNkBXBXBXBXBX
BXBXBXBXNkNkNkNkNkNkNkNkNkNkNkNkNkNkNkNkNkNkNkNkNkNkNkNkNkNkNkNkbDNkNkNkNkNkNkNkNkNkNkNkNkNkNkNkNkNkNkNkNkNkNkBXBXBXBXBX
BXBXBXBXNkNkNkNkNkNkNkNkNkNkNkNkNkNkNkNkNkNkNkNkNkNkNkNkNkNkNkbDNkNkNkNkNkNkNkNkNkNkNkNkNkNkNkNkNkNkNkNkNkNkNkBXBXBXBXBX
BXBXBXBXNkNkNkNkNkNkNkNkNkNkNkNkNkNkNkNkNkNkNkNkNkNkNkNkNkNkbDNkNkNkNkNkNkNkNkNkNkNkNkNkNkNkNkNkNkNkNkNkNkNkNkBXBXBXBXBX
BXBXBXBXNkNkNkNkNkNkNkNkNkNkNkNkNkNkNkNkNkNkNkNkNkNkNkNkNkbDNkNkNkNkNkNkNkNkNkNkNkNkNkNkNkNkNkNkNkNkNkNkNkNkNkBXBXBXBXBX
BXBXBXBXNkNkNkNkNkNkNkNkNkNkNkNkNkNkNkNkNkNkNkNkNkNkNkNkNkbDNkNkNkNkNkNkNkNkNkNkNkNkNkNkNkNkNkNkNkNkNkNkNkNkNkBXBXBXBXBX
BXBXBXBXNkNkNkNkNkNkNkNkNkNkNkNkNkNkNkNkNkNkNkNkNkNkNkNkbDNkNkNkNkNkNkNkNkNkNkNkNkNkNkNkNkNkNkNkNkNkNkNkNkNkNkBXBXBXBXBX
BXBXBXBXNkNkNkNkNkNkNkNkNkNkNkNkNkNkNkNkNkNkNkNkNkNkNkNkbDNkNkNkNkNkNkNkNkNkNkNkNkNkNkNkNkNkNkNkNkNkNkNkNkNkNkBXBXBXBXBX
BXBXBXBXNkNkNkNkNkNkNkNkNkNkNkNkNkNkNkNkNkNkRwNkNkNkNkNkbDNkNkNkRwNkNkNkNkNkNkNkNkNkNkNkNkNkNkNkNkNkNkNkNkNkNkBXBXBXBXBX
BXBXBXBXNkNkNkNkNkNkNkNkNkNkNkNkNkNkNkNkNkNkNkNkNkNkNkNkbDNkNkNkNkNkNkNkNkNkNkNkNkNkNkNkNkNkNkNkNkNkNkNkNkNkNkBXBXBXBXBX
BXBXBXBXNkNkNkNkNkNkNkNkNkNkNkNkNkNkNkNkNkBXBXNkNkNkNkNkbDNkNkNkBXBXNkNkNkNkNkNkNkNkNkNkNkNkNkNkNkNkNkNkNkNkNkBXBXBXBXBX
BXBXBXhqNkNkNkNkNkNkNkNkNkNkNkNkNkNkNkNkNkBXBXNkNkNkNkNkbDNkNkNkBXBXNkNkNkNkNkNkNkNkNkNkNkNkNkNkNkNkNkNkNkNkNkBXBXBXBXBX
BXBXhqhqNkNkNkNkNkNkNkNkNkNkNkNkNkNkNkNkNkNkNkNkNkNkNkNkbDNkNkNkNkNkNkNkNkNkNkNkNkNkNkNkNkNkNkNkNkNkNkNkNkNkSdhqhqBXBXBX
BXhqhqBXNkNkNkNkNkNkNkNkNkNkNkNkNkNkNkNkNkNkNkNkNkNkNkNkbDNkNkNkNkNkNkNkNkNkNkNkNkNkNkNkNkNkNkNkNkNkNkNkNkBXBXBXhqhqBXBX
BXhqBXBXBXBXNkBXNkNkNkNkBXNkNkNkNkNkNkNkNkNkNkNkNkNkNkNkbDNkNkNkNkNkNkNkNkNkNkNkNkNkNkNkNkBXBXBXBXBXBXBXBXBXBXBXBXhqBXBX
BXhqBXBXBXBXBXBXBXBXBXBXBXBXBXBXBXBXBXBXBXBXBXBXBXRwNkNkbDNkNkBXBXBXBXBXBXBXBXBXBXBXBXBXBXBXBXBXBXBXBXBXBXBXBXBXBXhqBXBX
BXhqBXBXBXBXBXBXBXBXBXBXBXBXBXBXBXBXBXBXBXBXBXBXBXBXNkNkbDNkNkRwBXBXBXBXBXBXBXBXBXBXBXBXBXBXBXBXBXBXBXBXBXBXBXBXBXhqBXBX
BXhqBXBXNkNkNkNkNkBXBXBXBXBXBXBXBXBXBXNkNkNkNkNkNkNkNkNkbDNkNkNkNkNkNkNkNkNkNkNkBXBXBXBXBXBXBXBXBXBXBXBXBXBXBXBXBXhqBXBX
BXhqBXBXNkNkNkNkNkNkNkNkNkNkBXBXBXBXNkNkNkNkNkNkNkNkNkNkbDNkNkNkNkNkNkNkNkNkNkNkNkNkNkNkNkNkNkNkNkNkNkNkNkNkNkBXBXhqBXBX
BXhqhqBXNkNkNkNkNkNkNkNkNkNkNkNkNkNkNkNkNkBXBXNkNkNkNkNkbDNkNkNkNkNkBXBXNkNkNkNkNkNkNkNkNkNkNkNkNkNkNkNkNkNkNkBXhqhqBXBX
BXBXhqhqSdNkNkNkNkNkNkNkNkNkNkNkNkNkNkNkNkBXBXNkNkNkNkNkbDNkNkNkNkNkBXBXNkNkNkNkNkNkNkNkNkNkNkNkNkNkNkNkNkNkSdhqhqBXBXBX
BXBXBXBXNkNkNkNkNkNkNkNkNkNkNkNkNkNkNkNkNkNkNkNkNkNkNkNkbDNkNkNkNkNkNkNkNkNkNkNkNkNkNkNkNkNkNkNkNkNkNkNkNkNkNkBXBXBXBXBX
BXBXBXBXNkNkNkNkNkNkNkNkNkNkNkNkNkNkNkNkNkNkRwNkNkNkNkNkbDNkNkNkNkNkRwNkNkNkNkNkNkNkNkNkNkNkNkNkNkNkNkNkNkNkNkBXBXBXBXBX
BXBXBXBXNkNkNkNkNkNkNkNkNkNkNkNkNkNkNkNkNkNkNkNkNkNkNkNkNkbDNkNkNkNkNkNkNkNkNkNkNkNkNkNkNkNkNkNkNkNkNkNkNkNkNkBXBXBXBXBX
BXBXBXBXNkNkNkNkNkNkNkNkNkNkNkNkNkNkNkNkNkNkNkNkNkNkNkNkNkbDNkNkNkNkNkNkNkNkNkNkNkNkNkNkNkNkNkNkNkNkNkNkNkNkNkBXBXBXBXBX
BXBXBXBXNkNkNkNkNkNkNkNkNkNkNkNkNkNkNkNkNkNkNkNkNkNkNkNkNkbDNkNkNkNkNkNkNkNkNkNkNkNkNkNkNkNkNkNkNkNkNkNkNkNkNkBXBXBXBXBX
BXBXBXBXNkNkNkNkNkNkNkNkNkNkNkNkNkNkNkNkNkNkNkNkNkNkNkNkNkbDNkNkNkNkNkNkNkNkNkNkNkNkNkNkNkNkNkNkNkNkNkNkNkNkNkBXBXBXBXBX
BXBXBXBXNkNkNkNkNkNkNkNkNkNkNkNkNkNkNkNkNkNkNkNkNkNkNkNkNkNkbDNkNkNkNkNkNkNkNkNkNkNkNkNkNkNkNkNkNkNkNkNkNkNkNkBXBXBXBXBX
BXBXBXBXNkNkNkNkNkNkNkNkNkNkNkNkNkNkNkNkNkNkNkNkNkNkNkNkNkNkbDNkNkNkNkNkNkNkNkNkNkNkNkNkNkNkNkNkNkNkNkNkNkNkNkBXBXBXBXBX
BXBXBXBXNkNkNkNkNkNkNkNkNkNkNkNkNkNkNkNkNkNkNkNkNkNkNkNkNkNkbDNkNkNkNkNkNkNkNkNkNkNkNkNkNkNkNkNkNkNkNkNkNkNkNkBXBXBXBXBX
BXBXBXBXNkNkNkNkNkNkNkNkNkNkNkNkNkNkNkNkNkNkNkNkNkNkNkNkNkNkbDNkNkNkNkNkNkNkNkNkNkNkNkNkNkNkNkNkNkNkNkNkNkNkNkBXBXBXBXBX
BXBXBXBXNkNkNkNkNkNkNkNkNkNkNkNkNkNkNkNkNkNkNkNkNkNkNkNkNkNkbDNkNkNkNkNkNkNkNkNkNkNkNkNkNkNkNkNkNkNkNkNkNkNkNkBXBXBXBXBX
BXBXBXBXNkNkNkNkNkNkNkNkNkNkNkNkNkNkNkNkNkNkNkNkNkNkNkNkNkNkbDNkNkNkNkNkNkNkNkNkNkNkNkNkNkNkNkNkNkNkNkNkNkNkNkBXBXBXBXBX
BXBXBXBXNkNkNkNkNkNkNkNkNkNkNkNkNkNkNkNkNkNkNkNkNkNkNkNkNkNkNkbDNkNkNkNkNkNkNkNkNkNkNkNkNkNkNkNkNkNkNkNkNkNkNkBXBXBXBXBX
BXBXBXBXNkNkNkNkNkNkNkNkNkNkNkNkNkNkNkNkNkNkNkNkNkNkNkNkNkNkNkbDNkNkNkNkNkNkNkNkNkNkNkNkNkNkNkNkNkNkNkNkNkNkNkBXBXBXBXBX
BXBXBXBXNkNkNkNkNkNkNkNkNkNkNkNkNkNkNkNkNkNkNkbDbDbDbDCcbDbDbDbDbDbDbDbDbDbDbDbDNkNkNkNkNkNkNkNkNkNkNkNkNkNkNkBXBXBXBXBX
BXBXBXBXNkNkNkNkNkNkNkNkNkNkNkNkNkNkNkNkNkNkNkbDNkNkNkNkNkNkNkbDNkNkNkNkNkNkNkbDNkNkNkNkNkNkNkNkNkNkNkNkNkNkNkBXBXBXBXBX
BXBXBXBXNkNkNkNkNkNkNkNkNkNkNkNkNkNkNkNkNkNkNkFvNkNkNkNkNkNkNkFvNkNkNkNkNkNkNkFvNkNkNkNkNkNkNkNkNkNkNkNkNkNkNkBXBXBXBXBX
BXBXBXBXNkNkNkNkNkNkNkNkNkNkNkNkNkNkNkNkNkNkFvFvFvNkNkNkNkNkFvFvFvNkNkNkNkNkFvFvFvNkNkNkNkNkNkNkNkNkNkNkNkNkNkBXBXBXBXBX
BXBXBXBXNkNkNkNkNkNkNkNkNkNkNkNkNkNkNkNkNkNkYwZdYwYwYwYwYwYwYwZdYwYwYwYwYwYwYwZdYwNkNkNkNkNkNkNkNkNkNkNkNkNkNkBXBXBXBXBX
BXBXBXBXNkNkNkNkNkNkNkNkNkNkNkNkNkNkNkNkNkBXYwFEAKKuqUdToeFEAKFEAKcbFEStFEcbAKFEYwBXNkNkNkNkNkNkNkNkNkNkNkNkNkBXBXBXBXBX
BXBXBXBXNkNkNkNkNkNkNkNkNkNkNkNkNkNkNkNkBXBXYwSOAKFEFEFEFEFEAKSOrnFEFEFEFEFErnSOYwBXNkNkNkNkNkNkNkNkNkNkNkNkNkBXBXBXBXBX
BXBXBXBXNkNkNkNkNkNkNkNkNkNkNkNkNkNkNkNkBXBXYwFEAKFEFEFEFEFEAKFEAKFEFEmRFEFEAKFEYwBXBXBXBXNkNkNkNkNkNkNkNkNkNkBXBXBXBXBX
BXBXBXBXNkNkNkNkNkNkNkNkNkNkNkBXBXBXBXBXBXBXYwFEAKFEFEFEFEFEAKFEAKFEFEFEFEFEAKFEYwBXBXBXBXNkNkNkNkNkNkNkNkNkNkBXBXBXBXBX
BXBXBXBXBXBXBXBXBXBXBXDSDYBXBXBXBXBXBXBXBXBXYwFEFEFEFEFEFEFEFEFEFEFEFEFEFEFEFEFEYwBXBXBXBXBXBXBXBXDYDSBXBXBXBXBXBXBXBXBX
BXBXBXBXBXBXBXBXBXBXBXDShfhfhfhfhfhfhfhfhfhfvwFEUJFEFEFEFEFEUJFEUJFEFEFEFEFEUJFEvwhfhfhfhfhfhfhfhfhfDSBXBXBXBXBXBXBXBXBX
BXBXBXBXBXBXBXBXBXBXBXDSDSDSDSDSDSDSDSDSDSDSYwAKAKAKAKAKAKAKAKAKAKAKAKAKAKAKAKAKYwDSDSDSDSDSDSDSDSDSDSBXBXBXBXBXBXBXBXBX
"}
(1,1,3) = {"
BXBXBXBXBXBXBXBXBXBXBXBXBXBXBXBXBXBXBXBXBXBXBXBXBXBXBXBXBXBXBXBXBXBXBXBXBXBXBXBXBXBXBXBXBXBXBXBXBXBXBXBXBXBXBXBXBXBXBXBX
BXBXBXBXBXBXBXBXBXBXBXBXBXBXBXBXBXBXBXBXBXBXBXBXBXBXBXBXBXBXBXBXBXBXBXBXBXBXBXBXBXBXBXBXBXBXBXBXBXBXBXBXBXBXBXBXBXBXBXBX
BXBXBXBXBXBXBXBXBXBXBXBXBXBXBXBXBXBXBXBXBXBXBXBXBXBXBXBXBXBXBXBXBXBXBXBXBXBXBXBXBXBXBXBXBXBXBXBXBXBXBXBXBXBXBXBXBXBXBXBX
BXBXBXBXBXBXBXBXBXBXKQBXBXBXBXBXBXBXBXBXJpJpJpJpJpJpJpbQJpJpJpJpJpJpJpBXBXBXBXBXBXBXKQKQKQKQKQKQKQKQKQKQKQKQKQBXBXBXBXBX
BXBXBXBXBXKQKQKQKQKQKQKQBXBXBXBXBXBXBXBXJpJpJpJpJpJpxdNpHKJpJpJpJpJpJpBXBXBXBXBXBXKQKQKQKQKQKQKQKQKQKQKQKQKQKQBXBXBXBXBX
BXBXBXBXKQKQKQKQKQKQKQKQBXBXBXBXBXBXBXBXJpgvJpJpJpgvxdNpHKgvJpJpJpgvJpBXBXBXBXBXKQKQKQKQKQKQKQKQKQKQKQKQKQKQKQBXBXBXBXBX
BXBXBXBXKQKQKQKQKQKQKQKQBXBXBXBXBXBXBXBXJpJpJpJpJpJpJpJpJpJpJpJpJpJpJpBXBXBXBXBXKQKQKQKQKQKQKQKQKQKQKQKQKQKQKQBXBXBXBXBX
BXBXBXBXBXKQKQKQKQKQKQKQKQKQBXBXBXBXBXBXOYOYOYOYOYOYOYOYOYOYOYOYOYOYOYBXBXBXBXBXKQKQKQKQKQKQKQKQKQKQKQKQKQKQKQBXBXBXBXBX
BXBXBXBXBXKQKQKQKQKQKQKQKQKQKQKQKQKQKQKQKQKQKQKQKQKQKQKQKQKQKQKQKQKQKQKQKQKQKQKQKQKQKQKQKQKQKQKQKQKQKQKQKQKQKQBXBXBXBXBX
BXBXBXBXBXKQKQKQKQKQKQKQKQKQKQKQKQKQKQKQKQKQKQKQKQKQKQKQKQKQKQKQKQKQKQKQKQKQKQKQKQKQKQKQKQKQKQKQKQKQKQKQKQKQKQBXBXBXBXBX
BXBXBXBXBXKQKQKQKQKQKQKQKQKQKQKQKQKQKQKQKQKQKQKQKQKQKQKQKQKQKQKQKQKQKQKQKQKQKQKQKQKQKQKQKQKQKQKQKQKQKQKQKQKQKQBXBXBXBXBX
BXBXBXBXKQKQKQKQKQKQKQKQKQKQKQKQKQKQKQKQKQKQKQKQKQKQKQKQKQKQKQKQKQKQKQKQKQKQKQKQKQKQKQKQKQKQKQKQKQKQKQKQKQKQKQBXBXBXBXBX
BXBXBXBXKQKQKQKQKQKQKQKQKQKQKQKQKQKQKQKQKQKQKQKQKQKQKQKQKQKQKQKQKQKQKQKQKQKQKQKQKQKQKQKQKQKQKQKQKQKQKQKQKQKQKQBXBXBXBXBX
BXBXBXBXKQKQKQKQKQKQKQKQKQKQKQKQKQKQKQKQKQKQKQKQKQKQKQKQKQKQKQKQKQKQKQKQKQKQKQKQKQKQKQKQKQKQKQKQKQKQKQKQKQKQKQBXBXBXBXBX
BXBXBXBXKQKQKQKQKQKQKQKQKQKQKQKQKQKQKQKQKQKQKQKQKQKQKQKQKQKQKQKQKQKQKQKQKQKQKQKQKQKQKQKQKQKQKQKQKQKQKQKQKQKQKQBXBXBXBXBX
BXBXBXBXKQKQKQKQKQKQKQKQKQKQKQKQKQKQKQKQKQKQKQKQKQKQKQKQKQKQKQKQKQKQKQKQKQKQKQKQKQKQKQKQKQKQKQKQKQKQKQKQKQKQKQBXBXBXBXBX
BXBXBXBXKQKQKQKQKQKQKQKQKQKQKQKQKQKQKQKQKQKQKQKQKQKQKQKQKQKQKQKQKQKQKQKQKQKQKQKQKQKQKQKQKQKQKQKQKQKQKQKQKQKQKQBXBXBXBXBX
BXBXBXBXKQKQKQKQKQKQKQKQKQKQKQKQKQKQKQKQKQKQKQKQKQKQKQKQKQKQKQKQKQKQKQKQKQKQKQKQKQKQKQKQKQKQKQKQKQKQKQKQKQKQKQBXBXBXBXBX
BXBXBXBXKQKQKQKQKQKQKQKQKQKQKQKQKQKQKQKQKQKQKQKQKQKQKQKQKQKQKQKQKQKQKQKQKQKQKQKQKQKQKQKQKQKQKQKQKQKQKQKQKQKQKQBXBXBXBXBX
BXBXBXBXKQKQKQKQKQKQKQKQKQKQKQKQKQKQKQKQKQKQKQKQKQKQKQKQKQKQKQKQKQKQKQKQKQKQKQKQKQKQKQKQKQKQKQKQKQKQKQKQKQKQKQBXBXBXBXBX
BXBXBXBXKQKQKQKQKQKQKQKQKQKQKQKQKQKQKQKQKQKQKQKQKQKQKQKQKQKQKQKQKQKQKQKQKQKQKQKQKQKQKQKQKQKQKQKQKQKQKQKQKQKQKQBXBXBXBXBX
BXBXBXBXKQKQKQKQKQKQKQKQKQKQKQKQKQKQKQKQKQKQKQKQKQKQKQKQKQKQKQKQKQKQKQKQKQKQKQKQKQKQKQKQKQKQKQKQKQKQKQKQKQKQKQBXBXBXBXBX
BXBXBXBXKQKQKQKQKQKQKQKQKQKQKQKQKQKQKQKQKQKQKQKQKQKQKQKQKQKQKQKQKQKQKQKQKQKQKQKQKQKQKQKQKQKQKQKQKQKQKQKQKQKQKQBXBXBXBXBX
BXBXBXBXKQKQKQKQKQKQKQKQKQKQKQKQKQKQKQKQKQlDlDKQKQKQKQKQKQKQKQKQlDlDKQKQKQKQKQKQKQKQKQKQKQKQKQKQKQKQKQKQKQKQKQBXBXBXBXBX
BXBXBXBXKQKQKQKQKQKQKQKQKQKQKQKQKQKQKQKQKQlDlDKQKQKQKQKQKQKQKQKQlDlDKQKQKQKQKQKQKQKQKQKQKQKQKQKQKQKQKQKQKQKQKQBXBXBXBXBX
BXBXBXBXKQKQKQKQKQKQKQKQKQKQKQKQKQKQKQKQKQKQKQKQKQKQKQKQKQKQKQKQKQKQKQKQKQKQKQKQKQKQKQKQKQKQKQKQKQKQKQKQKQKQKQBXBXBXBXBX
BXBXBXBXKQKQKQKQKQKQKQKQKQKQKQKQKQKQKQKQKQKQKQKQKQKQKQKQKQKQKQKQKQKQKQKQKQKQKQKQKQKQKQKQKQKQKQKQKQKQKQKQKQBXBXBXBXBXBXBX
BXBXBXBXBXBXKQBXKQKQKQKQBXKQKQKQKQKQKQKQKQKQKQKQKQKQKQKQKQKQKQKQKQKQKQKQKQKQKQKQKQKQKQKQKQBXBXBXBXBXBXBXBXBXBXBXBXBXBXBX
BXBXBXBXBXBXBXBXBXBXBXBXBXBXBXBXBXBXBXBXBXlDlDlDlDKQKQKQKQKQKQlDlDlDlDBXBXBXBXBXBXBXBXBXBXBXBXBXBXBXBXBXBXBXBXBXBXBXBXBX
BXBXBXBXBXBXBXBXBXBXBXBXBXBXBXBXBXBXBXBXBXlDlDlDlDlDKQKQKQKQKQKQlDlDlDBXBXBXBXBXBXBXBXBXBXBXBXBXBXBXBXBXBXBXBXBXBXBXBXBX
BXBXBXBXKQKQKQKQKQBXBXBXBXBXBXBXBXBXBXKQKQKQKQKQKQKQKQKQKQKQKQKQKQKQKQKQKQKQKQKQBXBXBXBXBXBXBXBXBXBXBXBXBXBXBXBXBXBXBXBX
BXBXBXBXKQKQKQKQKQKQKQKQKQKQBXBXBXBXKQKQKQKQKQKQKQKQKQKQKQKQKQKQKQKQKQKQKQKQKQKQKQKQKQKQKQKQKQKQKQKQKQKQKQKQKQBXBXBXBXBX
BXBXBXBXKQKQKQKQKQKQKQKQKQKQKQKQKQKQKQKQKQlDlDKQKQKQKQKQKQKQKQKQKQKQlDlDKQKQKQKQKQKQKQKQKQKQKQKQKQKQKQKQKQKQKQBXBXBXBXBX
BXBXBXBXKQKQKQKQKQKQKQKQKQKQKQKQKQKQKQKQKQlDlDKQKQKQKQKQKQKQKQKQKQKQlDlDKQKQKQKQKQKQKQKQKQKQKQKQKQKQKQKQKQKQKQBXBXBXBXBX
BXBXBXBXKQKQKQKQKQKQKQKQKQKQKQKQKQKQKQKQKQKQKQKQKQKQKQKQKQKQKQKQKQKQKQKQKQKQKQKQKQKQKQKQKQKQKQKQKQKQKQKQKQKQKQBXBXBXBXBX
BXBXBXBXKQKQKQKQKQKQKQKQKQKQKQKQKQKQKQKQKQKQKQKQKQKQKQKQKQKQKQKQKQKQKQKQKQKQKQKQKQKQKQKQKQKQKQKQKQKQKQKQKQKQKQBXBXBXBXBX
BXBXBXBXKQKQKQKQKQKQKQKQKQKQKQKQKQKQKQKQKQKQKQKQKQKQKQKQKQKQKQKQKQKQKQKQKQKQKQKQKQKQKQKQKQKQKQKQKQKQKQKQKQKQKQBXBXBXBXBX
BXBXBXBXKQKQKQKQKQKQKQKQKQKQKQKQKQKQKQKQKQKQKQKQKQKQKQKQKQKQKQKQKQKQKQKQKQKQKQKQKQKQKQKQKQKQKQKQKQKQKQKQKQKQKQBXBXBXBXBX
BXBXBXBXKQKQKQKQKQKQKQKQKQKQKQKQKQKQKQKQKQKQKQKQKQKQKQKQKQKQKQKQKQKQKQKQKQKQKQKQKQKQKQKQKQKQKQKQKQKQKQKQKQKQKQBXBXBXBXBX
BXBXBXBXKQKQKQKQKQKQKQKQKQKQKQKQKQKQKQKQKQKQKQKQKQKQKQKQKQKQKQKQKQKQKQKQKQKQKQKQKQKQKQKQKQKQKQKQKQKQKQKQKQKQKQBXBXBXBXBX
BXBXBXBXKQKQKQKQKQKQKQKQKQKQKQKQKQKQKQKQKQKQKQKQKQKQKQKQKQKQKQKQKQKQKQKQKQKQKQKQKQKQKQKQKQKQKQKQKQKQKQKQKQKQKQBXBXBXBXBX
BXBXBXBXKQKQKQKQKQKQKQKQKQKQKQKQKQKQKQKQKQKQKQKQKQKQKQKQKQKQKQKQKQKQKQKQKQKQKQKQKQKQKQKQKQKQKQKQKQKQKQKQKQKQKQBXBXBXBXBX
BXBXBXBXKQKQKQKQKQKQKQKQKQKQKQKQKQKQKQKQKQKQKQKQKQKQKQKQKQKQKQKQKQKQKQKQKQKQKQKQKQKQKQKQKQKQKQKQKQKQKQKQKQKQKQBXBXBXBXBX
BXBXBXBXKQKQKQKQKQKQKQKQKQKQKQKQKQKQKQKQKQKQKQKQKQKQKQKQKQKQKQKQKQKQKQKQKQKQKQKQKQKQKQKQKQKQKQKQKQKQKQKQKQKQKQBXBXBXBXBX
BXBXBXBXKQKQKQKQKQKQKQKQKQKQKQKQKQKQKQKQKQKQKQKQKQKQKQKQKQKQKQKQKQKQKQKQKQKQKQKQKQKQKQKQKQKQKQKQKQKQKQKQKQKQKQBXBXBXBXBX
BXBXBXBXKQKQKQKQKQKQKQKQKQKQKQKQKQKQKQKQKQKQKQKQKQKQKQKQKQKQKQKQKQKQKQKQKQKQKQKQKQKQKQKQKQKQKQKQKQKQKQKQKQKQKQBXBXBXBXBX
BXBXBXBXKQKQKQKQKQKQKQKQKQKQKQKQKQKQKQKQKQKQKQKQKQKQKQKQKQKQKQKQKQKQKQKQKQKQKQKQKQKQKQKQKQKQKQKQKQKQKQKQKQKQKQBXBXBXBXBX
BXBXBXBXKQKQKQKQKQKQKQKQKQKQKQKQKQKQKQKQKQKQKQKQKQKQKQKQKQKQKQKQKQKQKQKQKQKQKQKQKQKQKQKQKQKQKQKQKQKQKQKQKQKQKQBXBXBXBXBX
BXBXBXBXKQKQKQKQKQKQKQKQKQKQKQKQKQKQKQKQKQKQKQKQKQKQKQKQKQKQKQKQKQKQKQKQKQKQKQKQKQKQKQKQKQKQKQKQKQKQKQKQKQKQKQBXBXBXBXBX
BXBXBXBXKQKQKQKQKQKQKQKQKQKQKQKQKQKQKQKQKQKQKQKQKQKQKQKQKQKQKQKQKQKQKQKQKQKQKQKQKQKQKQKQKQKQKQKQKQKQKQKQKQKQKQBXBXBXBXBX
BXBXBXBXKQKQKQKQKQKQKQKQKQKQKQKQKQKQKQKQKQKQKQKQKQKQKQKQKQKQKQKQKQKQKQKQKQKQKQKQKQKQKQKQKQKQKQKQKQKQKQKQKQKQKQBXBXBXBXBX
BXBXBXBXKQKQKQKQKQKQKQKQKQKQKQKQKQKQKQKQKQKQKQKQKQKQKQKQKQKQKQKQKQKQKQKQKQKQKQKQKQKQKQKQKQKQKQKQKQKQKQKQKQKQKQBXBXBXBXBX
BXBXBXBXKQKQKQKQKQKQKQKQKQKQKQKQKQKQKQKQKQKQlDlDlDlDlDlDlDlDlDlDlDlDlDlDlDlDlDlDlDKQKQKQKQKQKQKQKQKQKQKQKQKQKQBXBXBXBXBX
BXBXBXBXKQKQKQKQKQKQKQKQKQKQKQKQKQKQKQKQKQKQlDlDlDlDlDlDlDlDlDlDlDlDlDlDlDlDlDlDlDKQKQKQKQKQKQKQKQKQKQKQKQKQKQBXBXBXBXBX
BXBXBXBXKQKQKQKQKQKQKQKQKQKQKQKQKQKQKQKQKQKQlDlDlDlDlDlDlDlDlDlDlDlDlDlDlDlDlDlDlDKQKQKQKQKQKQKQKQKQKQKQKQKQKQBXBXBXBXBX
BXBXBXBXKQKQKQKQKQKQKQKQKQKQKQKQKQKQKQKQKQKQlDlDlDlDlDlDlDlDlDlDlDlDlDlDlDlDlDlDlDKQKQKQKQKQKQKQKQKQKQKQKQKQKQBXBXBXBXBX
BXBXBXBXKQKQKQKQKQKQKQKQKQKQKQKQKQKQKQKQKQKQlDlDlDlDlDlDlDlDlDlDlDlDlDlDlDlDlDlDlDKQKQKQKQKQKQKQKQKQKQKQKQKQKQBXBXBXBXBX
BXBXBXBXBXBXBXBXBXBXBXBXBXBXBXBXBXBXBXBXBXBXBXBXBXBXBXBXBXBXBXBXBXBXBXBXBXBXBXBXBXBXBXBXBXBXBXBXBXBXBXBXBXBXBXBXBXBXBXBX
BXBXBXBXBXBXBXBXBXBXBXBXBXBXBXBXBXBXBXBXBXBXBXBXBXBXBXBXBXBXBXBXBXBXBXBXBXBXBXBXBXBXBXBXBXBXBXBXBXBXBXBXBXBXBXBXBXBXBXBX
BXBXBXBXBXBXBXBXBXBXBXBXBXBXBXBXBXBXBXBXBXBXBXBXBXBXBXBXBXBXBXBXBXBXBXBXBXBXBXBXBXBXBXBXBXBXBXBXBXBXBXBXBXBXBXBXBXBXBXBX
"}
