"a" = (/turf/closed/wall/purple,/area/maintenance/polovich/forest)
"b" = (/turf/open/openspace/norm,/area/maintenance/polovich/forest)
"c" = (/turf/open/floor/plating/polovich/stonestonestone/two,/area/maintenance/polovich/forest)
"d" = (/turf/closed/wall/r_wall,/area/maintenance/polovich/forest)
"e" = (/obj/structure/closet/cabinet,/turf/open/floor/plating/polovich/bluee,/area/maintenance/polovich/forest)
"f" = (/turf/open/floor/plating/polovich/bluee,/area/maintenance/polovich/forest)
"g" = (/turf/open/floor/plating/polovich/stonestonestone/two,/area/maintenance/polovich/evilplace)
"h" = (/obj/machinery/light/small/directional/south,/turf/open/floor/plating/polovich/stonestonestone/two,/area/maintenance/polovich/evilplace)
"i" = (/obj/machinery/light/small/red/directional/south,/turf/open/floor/plating/polovich/stonestonestone/two,/area/maintenance/polovich/evilplace)
"j" = (/turf/open/floor/plating/polovich/kollo,/area/maintenance/polovich/forest)
"k" = (/turf/open/floor/plating/polovich/stonestonestone/two,/area/maintenance/polovich/village)
"l" = (/obj/machinery/door/metal_door/west,/turf/open/floor/plating/polovich/stonestonestone/two,/area/maintenance/polovich/village)
"m" = (/obj/machinery/door/metal_door/east,/turf/open/floor/plating/polovich/stonestonestone/two,/area/maintenance/polovich/evilplace)
"n" = (/obj/machinery/door/metal_door/west,/turf/open/floor/plating/polovich/stonestonestone/two,/area/maintenance/polovich/evilplace)
"o" = (/obj/structure/trap/fire,/turf/open/floor/plating/polovich/stonestonestone/two,/area/maintenance/polovich/evilplace)
"p" = (/turf/open/floor/plating/polovich/warlocksticky,/area/maintenance/polovich/forest)
"q" = (/obj/machinery/door/metal_door/wood_door/west,/turf/closed/wall/r_wall,/area/maintenance/polovich/forest)
"r" = (/turf/open/floor/plating/polovich/magicsteel,/area/maintenance/polovich/forest)
"s" = (/obj/structure/stairs/south,/turf/open/floor/plating/polovich/kollo,/area/maintenance/polovich/forest)
"t" = (/obj/structure/railing{dir = 4},/turf/open/openspace/norm,/area/maintenance/polovich/forest)
"u" = (/obj/structure/railing{dir = 1},/turf/open/floor/plating/polovich/slush,/area/maintenance/polovich/forest)
"v" = (/turf/open/floor/plating/polovich/temnoo/five,/area/maintenance/polovich/forest)
"w" = (/turf/open/floor/plating/polovich/temnoo,/area/maintenance/polovich/forest)
"x" = (/obj/structure/railing{dir = 1},/turf/open/floor/plating/polovich/temnoo,/area/maintenance/polovich/forest)
"y" = (/obj/structure/railing{dir = 8},/turf/open/openspace/norm,/area/maintenance/polovich/forest)
"z" = (/turf/open/floor/plating/polovich/temnoo/seven,/area/maintenance/polovich/forest)
"A" = (/turf/open/floor/plating/polovich/slush,/area/maintenance/polovich/forest)
"B" = (/turf/open/floor/plating/polovich/rockydarkness,/area/maintenance/polovich/forest)
"C" = (/turf/open/floor/plating/polovich/greengryaz,/area/maintenance/polovich/forest)
"D" = (/turf/open/floor/plating/polovich/lightblue,/area/maintenance/polovich/forest)
"E" = (/turf/open/floor/plating/polovich/dirt/dark/gryazka,/area/maintenance/polovich/forest)
"F" = (/obj/structure/flora/ausbushes/crystal/dark,/turf/open/floor/plating/polovich/dirt/dark/gryazka,/area/maintenance/polovich/forest)
"G" = (/turf/closed/wall/r_wall/alt,/area/maintenance/polovich/forest)
"H" = (/turf/open/floor/plating/polovich/greenstone{dir = 6},/area/maintenance/polovich/forest)
"I" = (/turf/open/floor/plating/polovich/greenstone{dir = 8},/area/maintenance/polovich/forest)
"J" = (/turf/open/floor/plating/polovich/greenstone,/area/maintenance/polovich/forest)
"K" = (/turf/open/floor/plating/polovich/greendirtevil,/area/maintenance/polovich/forest)
"L" = (/obj/structure/mineral_door/iron,/turf/open/floor/plating/polovich/dirt/dark/gryazka,/area/maintenance/polovich/forest)
"M" = (/turf/closed/wall/mineral/wood/alt,/area/maintenance/polovich/forest)
"N" = (/obj/machinery/door/unpowered/podpol,/turf/open/floor/plating/polovich/bronzefloor,/area/maintenance/polovich/forest)
"O" = (/turf/open/floor/plating/polovich/woodens,/area/maintenance/polovich/forest)
"P" = (/turf/open/floor/plating/polovich/woodenss,/area/maintenance/polovich/forest)
"Q" = (/turf/open/floor/plating/polovich/woodennew,/area/maintenance/polovich/forest)
"R" = (/obj/structure/mineral_door/iron,/turf/open/floor/plating/polovich/greendirtevil,/area/maintenance/polovich/forest)
"S" = (/obj/structure/barricade/flora/crystal/green,/turf/open/floor/plating/polovich/greendirtevil,/area/maintenance/polovich/forest)
"T" = (/turf/open/floor/plating/polovich/asteroid/snow/river/nevado_surface/shallow/ankle,/area/maintenance/polovich/forest)
"U" = (/obj/structure/mineral_door/iron,/turf/open/floor/plating/polovich/greengryaz,/area/maintenance/polovich/forest)
"V" = (/obj/structure/closet/cabinet,/obj/item/changeable_attacks/slashstab/sabre/small/steel/fast,/turf/open/floor/plating/polovich/bluee,/area/maintenance/polovich/forest)

(1,1,1) = {"
aaaaaaaaaaaaaaaaaaaaaaaaaaaaaaaaaaaaaaaaaaaaaaaaaaaaaaaaaaaaaaaaaaaaaaaaaaaaaaaaaaaaaaaaaaaaaaaaaaaaaaaaaaaaaaaaaaaaaaaaaaaaa
abbbbbbbbbbbbbbbbbbbbbbbbbbbbbbbbbbbbbbbbbbbbbbbbbbbbbbbbbbbbbbbbbbbbbbbbbbbbbbbbbbbbbbbbbbbbbbbbbbbbbbbbbbbbbbbbbbbbbbbbbbba
abbbbbbbbbbbbbbbbbbbbbbbbbbbbbbbbbbbbbbbbbbbbbbbbbbbbbbbbbbbbbbbbbbbbbbbbbbbbbbbbbbbbbbbbbbbbbbbbbbbbbbbbbbbbbbbbbbbbbbbbbbba
abbbbbbbbbbbbbbbbbbbbbbbbbbbbbbbbbbbbbbbbbbbbbbbbbbbbbbbbbbbbbbbbbbbbbbbbbbbbbbbbbbbbbbbbbbbbbbbbbbbbbbbbbbbbbbbbbbbbbbbbbbba
abbbbbbbbbbbbbbbbbbbbbbbbbbbbbbbbbbbbbbbbbbbbbbbbbbbbbbbbbbbbbbbbbbbbbbbbbbbbbbbbbbbbbbbbbbbbbbbbbbbbbbbbbbbbbbbbbbbbbbbbbbba
abbbbbbbbbbbbbbbbbbbbbbbbbbbbbbbbbbbbbbbbbbbbbbbbbbbbbbbbbbbbbbbbbbbbbbbbbbbbbbbbbbbbbbbbbbbbbbbbbbbbbbbbbbbbbbbbbbbbbbbbbbba
abbbbbbbbbbbbbbbbbbbbbbbbbbbbbbbbbbbbbbbbbbbbbbbbbbbbbbbbbbbbbbbbbbbbbbbbbbbbbbbbbbbbbbbbbbbbbbbbbbbbbbbbbbbbbbbbbbbbbbbbbbba
abbbbbbbbbbbbbbbbbbbbbbbbbbbbbbbbbbbbbbbbbbbbbbbbbbbbbbbbbbbbbbbbbbbbbbbbbbbbbbbbbbbbbbbbbbbbbbbbbbbbbbbbbbbbbbbbbbbbbbbbbbba
abbbbbbbbbbbbbbbbbbbbbbbbbbbbbbbbbbbbbbbbbbbbbbbbbbbbbbbbbbbbbbbbbbbbbbbbbbbbbbbbbbbbbbbbbbbbbbbbbbbbbbbbbbbbbbbbbbbbbbbbbbba
abbbbbbbbbbbbbbbbbbbbbbbbbbbbbbbbbbbbbbbbbbbbbbbbbbbbbbbbbbbbbbbbbbbbbbbbbbbbbbbbbbbbbbbbbbbbbbbbbbbbbbbbbbbbbbbbbbbbbbbbbbba
abbbbbbbbbbbbbbbbbbbbbbbbbbbbbbbbbbbbbbbbbbbbbbbbbbbbbbbbbbbbbbbbbbbbbbbbbbbbbbbbbbbbbbbbbbbbbbbbbbbbbbbbbbbbbbbbbbbbbbbbbbba
abbbbbbbbbbbbbbbbbbbbbbbbbbbbbbbbbbbbbbbbbbbbbbbbbbbbbbbbbbbbbbbbbbbbbbbbbbbbbbbbbbbbbbbbbbbbbbbbbbbbbbbbbbbbbbbbbbbbbbbbbbba
abbbbbbbbbbbbbbbbbbbbbbbbbbbbbbbbbbbbbbbbbbbbbbbbbbbbbbbbbbbbbbbbbbbbbbbbbbbbbbbbbbbbbbbbbbbbbbbbbbbbbbbbbbbbbbbbbbbbbbbbbbba
abbbbbbbbbbbbbbbbbbbbbbbbbbbbbbbbbbbbbbbbbbbbbbbbbbbbbbbbbbbbbbbbbbbbbbbbbbbbbbbbbbbbbbbbbbbbbbbbbbbbbbbbbbbbbbbbbbbbbbbbbbba
abbbbbbbbbbbbbbbbbbbbbbbbbbbbbbbbbbbbbbbbbbbbbbbbbbbbbbbbbbbbbbbbbbbbbbbbbbbbbbbbbbbbbbbbbbbbbbbbbbbbbbbbbbbbbbbbbbbbbbbbbbba
abbbbbbbbbbbbbbbbbbbbbbbbbbbbbbbbbbbbbbbbbbbbbbbbbbbbbbbbbbbbbbbbbbbbbbbbbbbbbbbbbbbbbbbbbbbbbbbbbbbbbbbbbbbbbbbbbbbbbbbbbbba
abbbbbbbbbbbbbbbbbbbbbbbbbbbbbbbbbbbbbbbbbbbbbbbbbbbbbbbbbbbbbbbbbbbbbbbbbbbbbbbbbbbbbbbbbbbbbbbbbbbbbbbbbbbbbbbbbbbbbbbbbbba
abbbbbbbbbbbbbbbbbbbbbbbbbbbbbbbbbbbbbbbbbbbbbbbbbbbbbbbbbbbbbbbbbbbbbbbbbbbbbbbbbbbbbbbbbbbbbbbbbbbbbbbbbbbbbbbbbbbbbbbbbbba
abbbbbbbbbbbbbbbbbbbbbbbbbbbbbbbbbbbbbbbbbbbbbbbbbbbbbbbbbbbbbbbbbbbbbbbbbbbbbbbbbbbbbbbbbbbbbbbbbbbbbbbbbbbbbbbbbbbbbbbbbbba
abbbbbbbbbbbbbbbbbbbbbbbbbbbbbbbbbbbbbbbbbbbbbbbbbbbbbbbbbbbbbbbbbbbbbbbbbbbbbbbbbbbbbbbbbbbbbbbbbbbbbbbbbbbbbbbbbbbbbbbbbbba
abbbbbbbbbbbbbbbbbbbbbbbbbbbbbbbbbbbbbbbbbbbbbbbbbbbbbbbbbbbbbbbbbbbbbbbbbbbbbbbbbbbbbbbbbbbbbbbbbbbbbbbbbbbbbbbbbbbbbbbbbbba
abbbbbbbbbbbbbbbbbbbbbbbbbbbbbbbbbbbbbbbbbbbbbbbbbbbbbbbbbbbbbbbbbbbbbbbbbbbbbbbbbbbbbbbbbbbbbbbbbbbbbbbbbbbbbbbbbbbbbbbbbbba
abbbbbbbbbbbbbbbbbbbbbbbbbbbbbbbbbbbbbbbcccbbbbccccccccccccccccccbbbbbbbbbbbbbbbbbbbbbbbbbbbbbbbbbbbbbbbbbbbbbbbbbbbbbbbbbbba
abbbbbbbbbbbbbbbbbbbbbbbbbbbbbbbbbbbbbbccccbbcccccccccccccccccccccccbbbbbbbbbbbbbbbbbbbbbbbbbbbbbbbbbbbbbbbbbbbbbbbbbbbbbbbba
abbbbbbbbbbbbbbbbbbbbbbbbbbbbbbbbbbbbcccccccccccccccccccccccccccccccbbbbbbbbbbbbbbbbbbbbbbbbbbbbbbbbbbbbbbbbbbbbbbbbbbbbbbbba
abbbbbbbbbbbbbbbbbbbbbbbbbbbbbbbbbbcccccccccccccccccccccccccccccccccccbbbbbbbbbbbbbbbbbbbbbbbbbbbbbbbbbbbbbbbbbbbbbbbbbbbbbba
abbbbbbbbbbbbbbbbbbbbbbbbbbbbbbbbbccccccccccccccccccccccccccccccccccccbbbbbbbbbbbbbbbbbbbbbbbbbbbbbbbbbbbbbbbbbbbbbbbbbbbbbba
abbbbbbbbbbbbbbbbbbbbbbbbbbbbbbbbbccccccccccccccccccccccccccccccccccccbbbbbbbbbbbbbbbbbbbbbbbbbbbbbbbbbbbbbbbbbbbbbbbbbbbbbba
abbbbbbbbbbbbbbbbbbbbbbbbbbbbbbbbcccccccccccccccccccccccccccccccccccccbbbbbbbbbbbbbbbbbbbbbbbbbbbbcbbbbbbbbbbbbbbbbbbbbbbbbba
abbbbbbbbbbbbbbbbbbbbbbbbbbbbcccccccccccccccccccccccccccccccccccccbbbbbbbbbbbbbbbbbbbbbbbbbbbbbbbbccbbbbbbbbbbbbbbbbbbbbbbbba
abbbbbbbbbbbbbbbbbbbbbbbbbbbccccccccccccccccccccccccccccccccccccccbbbbbbbbbbbbbbbbbbbbbbbbbbbbbbcccccbbbbbbbbbbbbbbbbbbbbbbba
abbbbbbbbbbbbbbbbbbbbbbbbbbbbcccccccccccccccaaccccccccccccccccccccbbbbbbbbbbbbbbbbbbbbbbbbcccccccccccccbbbbbbbbbbbbbbbbbbbbba
abbbbbbbbbbbbbbbbbbbbbbbbbbbbcccccccccccccaaaaacccccccccccccccccccbbbbbbbbbbbbbbbbbbbbcbbbcccccccccccbbbbbbbbbbbbbbbbbbbbbbba
abbbbbbbbbbbbbbbbbbbbbbbbbbbccccccccccccaaaaaaaaacccccccccccccccccccbbbbbbbbbbbbbbbbbbcbbbcccccccccccbbbbbbbbbbbbbbbbbbbbbbba
abbbbbbbbbbbbbbbbbbbbbbbbbbbcccccccccccaaaabaaaaaacccccccccccccccccccbbbbbbbbbbbbbbbbbbggggccccccccccccccccbbbbbbbbbbbbbbbbba
abbbbbbbbbbbbbbbbbbbbbbbbbbbccccccccccccaaaaaaaaaaaccccccccccccckkkccbbbbbbbbbbbbbbbbbgggggcccgggggccccccccccccbbbbbbbbbbbbba
abbbbbbbbbbbbbbbbbbbbbbbbbbbcccccccccccccaaaaaaaaccccccccccccccccckccbbbbbbbbbbbbbbbbbgggggccggccggccccccccccccbbbbbbbbbbbbba
abbbbbbbbbbbbbbbbbbbbbbbbbbbbccccccccccccccaaccccccccccccccccccckkkcbbbbbbbbbbbbcccccccccccgggggggggggggggggcccbbbbbbbbbbbbba
abbbbbbbbbbbbbbbbbbbbbbbbbbbbccccccccccccccccccccccccccccccccccckkklbbbbbbbbbbbbcccccccccccggggcccggggggggggccccccbbbbbbbbbba
abbbbbbbbbbbbbbbbbbbbbbbbbbbcccccccccccccccccccccccccccccccccccckkkcbbbbbbbbbbbbcccccccccccgggncccmgggggggggcccccbbbbbbbbbbba
abbbbbbbbbbbbbbbbbbbbbbbbbbbcccccccccccccccccccccccccccccccccccckkcccbbbbbbbbbbbcccccccccccggggcccggggggggggcccccbbbbbbbbbbba
abbbbbbbbbbbbbbbbbbbbbbbbbbbbccccccccccccccccccccccccccccccccccccccccbbbbbbbbbbbcccccccccccgggggggggggggggggccccbbbbbbbbbbbba
abbbbbbbbbbbbbbbbbbbbbbbbbbbbcccccccccccccccccccccccccccccccccccccccbbbbbbbbbbbbbbbbbbgcccccccgggggccccccccccccccbbbbbbbbbbba
abbbbbbbbbbbbbbbbbbbbbbbbbbbbccccccccccccccccccccccccccccccccccccccbbbbbbbbbbbbbbbbbbbgccccccgggggggggggggcccccccbbbbbbbbbbba
abbbbbbbbbbbbbbbbbbbbbbbbbbbbbcccccccccccccccccccccccccccccccccccccbbbbbbbbbbbbbbbbbbbgccccgcggggggggcggggcccbbbbbbbbbbbbbbba
abbbbbbbbbbbbbbbbbbbbbbbbbbbbbbbccccccccccccccccccccccccccccccccccccbbbbbbbbbbbbbbbbbbgccccgggggggggggggggccbbbbbbbbbbbbbbbba
abbbbbbbbbbbbbbbbbbbbbbbbbbbbbbcccccccccccccccccccccccccccccccccccccbbbbbbbbbbbbbbbbbbgccccgggggggggggggggccabbbbbbbbbbbbbbba
abbbbbbbbbbbbbbbbbbbbbbbbbbbbbbcccccccccccccccccccccccccccccgggggggggggggggggccccccccccccccggggccccccccgggccabbbbbbbbbbbbbbba
abbbbbbbbbbbbbbbbbbbbbbbbbbbbbbcccccccccccccccccccccccccccccgggggmgggggggngggccccccccccccccggggccccccccgggcccccbbbbbbbbbbbbba
abbbbbbbbbbbbbbbbbbbbbbbbbbbbbbcccccccccccccccccccccccccccccgggggmggggggongggccccccccccccccggggccccccccgggcccccccbbbbbbbbbbba
abbbbbbbbbbbbbbbbbbbbbbbbbbbbbbbccccccccccccccccccccccccccccggggggcgggggcggghccccccccccccccggggccccccccgggcccccccbbbbbbbbbbba
abbbbbbbbbbbbbbbbbbbbbbbbbbbbbbbbccccccbbbbbccccccccccccccccgggggggggggggggggccccccccccccccgggggggggggggggcccccbbbbbbbbbbbbba
abbbbbbbbbbbbbbbbbbbbbbbbbbbbbbbbccccccbbbcccccccccccccccccccccccgggggggggccccccccccccccccccggggggggggggggccccbbbbbbbbbbbbbba
abbbbbbbbbbbbbbbbbbbbbbbbbbbbbbbbbbbbbbbbbcccccccccccccccccccccccgggggggggccccccccccccccccccggggggggggggggcccbbbbbbbbbbbbbbba
abbbbbbbbbbbbbbbbbbbbbbbbbbbbbbbbbbbbbbbbccccccccccccccccccccccccggigggiggcccccccccccccccccccggggggggggggcccbbbbbbbbbbbbbbbba
abbbbbbbbbbbbbbbbbbbbbbbbbbbbbbbbbbbbbbbbccccccccccccccccccccccccgggggggggccccccccccccccccccccccccggggggccccbbbbbbbbbbbbbbbba
abbbbbbbbbbbbbbbbbbbbbbbbbbbbbbbbbbbbbbbbccccccccccccccccccccccccccccccccccccccbbbbbbbbbcccccccccccgggggcccbbbbbbbbbbbbbbbbba
abbbbbbbbbbbbbbbbbbbbbbbbbbbbbbbbbbbbbbbbbcccccccccccccccccccccccccccccccccccbbbbbbbbbbbbbccccccccccccccccbbbbbbbbbbbbbbbbbba
abbbbbbbbbbbbbbbbbbbbbbbbbbbbbbbbbbbbbbbbbbccccccccbbbbbbbbbccccbbbbbbbbbbbbbbbbbbbbbbbbbbbbbbbbbbbbbbbbbbbbbbbbbbbbbbbbbbbba
abbbbbbbbbbbbbbbbbbbbbbbbbbbbbbbbbbbbbbbbbbbbccccbbbbbbbbbbbbbbbbbbbbbbbbbbbbbbbbbbbbbbbbbbbbbbbbbbbbbbbbbbbbbbbbbbbbbbbbbbba
abbbbbbbbbbbbbbbbbbbbbbbbbbbbbbbbbbbbbbbbbbbbbbbbbbbbbbbbbbbbbbbbbbbbbbbbbbbbbbbbbbbbbbbbbbbbbbbbbbbbbbbbbbbbbbbbbbbbbbbbbbba
abbbbbbbbbbbbbbbbbbbbbbbbbbbbbbbbbbbbbbbbbbbbbbbbbbbbbbbbbbbbbbbbbbbbbbbbbbbbbbbbbbbbbbbbbbbbbbbbbbbbbbbbbbbbbbbbbbbbbbbbbbba
abbbbbbbbbbbbbbbbbbbbbbbbbbbbbbbbbbbbbbbbbbbbbbbbbbbbbbbbbbbbbbbbbbbbbbbbbbbbbbbbbbbbbbbbbbbbbbbbbbbbbbbbbbbbbbbbbbbbbbbbbbba
abbbbbbbbbbbbbbbbbbbbbbbbbbbbbbbbbbbbbbbbbbbbbbbbbbbbbbbbbbbbbbbbbbbbbbbbbbbbbbbbbbbbbbbbbbbbbbbbbbbbbbbbbbbbbbbbbbbbbbbbbbba
abbbbbbbbbbbbbbbbbbbbbbbbbbbbbbbbbbbbbbbbbbbbbbbbbbbbbbbbbbbbbbbbbbbbbbbbbbbbbbbbbbbbbbbbbbbbbbbbbbbbbbbbbbbbbbbbbbbbbbbbbbba
abbbbbbbbbbbbbbbbbbbbbbbbbbbbbbbbbbbbbbbbbbbbbbbbbbbbbbbbbbbbbbbbbbbbbbbbbbbbbbbbbbbbbbbbbbbbbbbbbbbbbbbbbbbbbbbbbbbbbbbbbbba
abbbbbbbbbbbbbbbbbbbbbbbbbbbbbbbbbbbbbbbbbbbbbbbbbbbbbbbbbbbbbbbbbbbbbbbbbbbbbbbbbbbbbbbbbbbbbbbbbbbbbbbbbbbbbbbbbbbbbbbbbbba
abbbbbbbbbbbbbbbbbbbbbbbbbbbbbbbbbbbbbbbbbbbbbbbbbbbbbbbbbbbbbbbbbbbbbbbbbbbbbbbbbbbbbbbbbbbbbbbbbbbbbbbbbbbbbbbbbbbbbbbbbbba
abbbbbbbbbbbbbbbbbbbbbbbbbbbbbbbbbbbbbbbbbbbbbbbbbbbbbbbbbbbbbbbbbbbbbbbbbbbbbbbbbbbbbbbbbbbbbbbbbbbbbbbbbbbbbbbbbbbbbbbbbbba
abbbbbbbbbbbbbbbbbbbbbbbbbbbbbbbbbbbbbbbbbbbbbbbbbbbbbbbbbbbbbbbbbbbbbbbbbbbbbbbbbbbbbbbbbbbbbbbbbbbbbbbbbbbbbbbbbbbbbbbbbbba
abbbbbbbbbbbbbbbbbbbbbbbbbbbbbbbbbbbbbbbbbbbbbbbbbbbbbbbbbbbbbbbbbbbbbbbbbbbbbbbbbbbbbbbbbbbbbbbbbbbbbbbbbbbbbbbbbbbbbbbbbbba
abbbbbbbbbbbbbbbbbbbbbbbbbbbbbbbbbbbbdddddddddbbbbbbbbbbbbbbbbbbbbbbbbbbbbbbbbbbbbbbbbbbbbbbbbbbbbbbbbbbbbbbbbbbbbbbbbbbbbbba
abbbbbbbbbbbbbbbbbbbbbbbbbbbbbbbbbbbbdVfjjjfedbbbbbbbbbbbbbbbbbbbbbbbbbbbbbbbbbbbbbbbbbbbbbbbbbbbbbbbbbbbbbbbbbbbbbbbbbbbbbba
abbbbbbbbbbbbbbbbbbbbbbbbbbbbbbbbbbbbdfpjbjpfdbbbbbbbbbbbbbbbbbbbbbbbbbbbbbbbbbbbbbbbbbbbbbbbbbbbbbbbbbbbbbbbbbbbbbbbbbbbbbba
abbbbbbbbbbbbbbbbbbbbbbbbbbbbbbbbbbbbdjjjbjjjdbbbbbbbbbbbbbbbbbbbbbbbbbbbbbbbbbbbbbbbbbbbbbbbbbbbbbbbbbbbbbbbbbbbbbbbbbbbbbba
abbbbbbbbbbbbbbbbbbbbbbbbbbbbbbbbbbbbqjjjrjjjdbbbbbbbbbbbbbbbbbbbbbbbbbbbbbbbbbbbbbbbbbbbbbbbbbbbbbbbbbbbbbbbbbbbbbbbbbbbbbba
abbbbbbbbbbbbbbbbbbbbbbbbbbbbbbbbbbbbdfpjsjpfdbbbbbbbbbbbbbbbbbbbbbbbbbbbbbbbbbbbbbbbbbbbbbbbbbbbbbbbbbbbbbbbbbbbbbbbbbbbbbba
abbbbbbbbbbbbbbbbbbbbbbbbbbbbbbbbbbbbdffjdjffdbbbbbbbbbbbbbbbbbbbbbbbbbbbbbbbbbbbbbbbbbbbbbbbbbbbbbbbbbbbbbbbbbbbbbbbbbbbbbba
abbbbbbbbbbbbbbbbbbbbbbbbbbbbbbbbbbbbdddddddddbbbbbbbbbbbbbbbbbbbbbbbbbbbbbbbbbbbbbbbbbbbbbbbbbbbbbbbbbbbbbbbbbbbbbbbbbbbbbba
abbbbbbbbbbbbbbbbbbbbbbbbbbbbbbbbbbbbbbbbbbbbbbbbbbbbbbbbbbbbbbbbbbbbbbbbbbbbbbbbbbbbbbbbbbbbbbbbbbbbbbbbbbbbbbbbbbbbbbbbbbba
abbbbbbbbbbbbbbbbbbbbbbbbbbbbbbbbbbbbbbbbbbbbbbbbbbbbbbbbbbbbbbbbbbbbbbbbbbbbbbbbbbbbbbbbbbbbbbbbbbbbbbbbbbbbbbbbbbbbbbbbbbba
abbbbbbbbbbbbbbbbbbbbbbbbbbbbbbbbbbbbbbbbbbbbbbbbbbbbbbbbbbbbbbbbbbbbbbbbbbbbbbbbbbbbbbbbbbbbbbbbbbbbbbbbbbbbbbbbbbbbbbbbbbba
abbbbbbbbbbbbbbbbbbbbbbbbbbbbbbbbbbbbbbbbbbbbbbbbbbbbbbbbbbbbbbbbbbbbbbbbbbbbbbbbbbbbbbbbbbbbbbbbbbbbbbbbbbbbbbbbbbbbbbbbbbba
abbbbbbbbbbbbbbbbbbbbbbbbbbbbbbbbbbbbbbbbbbbbbbbbbbbbbbbbbbbbbbbbbbbbbbbbbbbbbbbbbbbbbbbbbbbbbbbbbbbbbbbbbbbbbbbbbbbbbbbbbbba
abbbbbbbbbbbbbbbbbbbbbbbbbbbbbbbbbbbbbbbbbbbbbbbbbbbbbbbbbbbbbbbbbbbbbbbbbbbbbbbbbbbbbbbbbbbbbbbbbbbbbbbbbbbbbbbbbbbbbbbbbbba
abbbbbbbbbbbbbbbbbbbbbbbbbbbbbbbbbbbbbbbbbbbbbbbbbbbbbbbbbbbbbbbbbbbbbbbbbbbbbbbbbbbbbbbbbbbbbbbbbbbbbbbbbbbbbbbbbbbbbbbbbbba
abbbbbbbbbbbbbbbbbbbbbbbbbbbbbbbbbbbbbbbbbbbbbbbbbbbbbbbbbbbbbbbbbbbbbbbbbbbbbbbbbbbbbbbbbbbbbbbbbbbbbbbbbbbbbbbbbbbbbbbbbbba
abbbbbbbbbbbbbbbbbbbbbbbbbbbbbbbbbbbbbbbbbbbbbbbbbbbbbbbbbbbbbbbbbbbbbbbbbbbbbbbbbbbbbbbbbbbbbbbbbbbbbbbbbbbbbbbbbbbbbbbbbbba
abbbbbbbbbbbbbbbbbbbbbbbbbbbbbbbbbbbbbbbbbbbbbbbbbbbbbbbbbbbbbbbbbbbbbbbbbbbbbbbbbbbbbbbbbbbbbbbbbbbbbbbbbbbbbbbbbbbbbbbbbbba
abbbbbbbbbbbbbbbbbbbbbbbbbbbbbbbbbbbbbbbbbbbbbbbbbbbbbbbbbbbbbbbbbbbbbbbbbbbbbbbbbbbbbbbbbbbbbbbbbbbbbbbbbbbbbbbbbbbbbbbbbbba
abbbbbbbbbbbbbbbbbbbbbbbbbbbbbbbbbbbbbbbbbbbbbbbbbbbbbbbbbbbbbbbbbbbbbbbbbbbbbbbbbbbbbbbbbbbbbbbbbbbbbbbbbbbbbbbbbbbbbbbbbbba
abbbbbbbbbbbbbbbbbbbbbbbbbbbbbbbbbbbbbbbbbbbbbbbbbbbbbbbbbbbbbbbbbbbbbbbbbbbbbbbbbbbbbbbbbbbbbbbbbbbbbbbbbbbbbbbbbbbbbbbbbbba
abbbbbbbbbbbbbbbbbbbbbbbbbbbbbbbbbbbbbbbbbbbbbbbbbbbbbbbbbbbbbbbbbbbbbbbbbbbbbbbbbbbbbbbbbbbbbbbbbbbbbbbbbbbbbbbbbbbbbbbbbbba
abbbbbbbbbbbbbbbbbbbbbbbbbbbbbbbbbbbbbbbbbbbbbbbbbbbbbbbbbbtuvwvxybbbbbbbbbbbbbbbbbbbbbbbbbbbbbbbbbbbbbbbbbbbbbbbbbbbbbbbbbba
abbbbbbbbbbbbbbbbbbbbbbbbbbbbbbbbbbbbbbbbbbbbbbbbbbbbbbbbbbtzwvwvybbbbbbbbbbbbbbbbbbbbbbbbbbbbbbbbbbbbbbbbbbbbbbbbbbbbbbbbbba
abbbbbbbbbbbbbbbbbbbbbbbbbbbbbbbbbbbbbbbbbbbbbbbbbbbbbbbbbbaAwBwwaabbbbbbbbbbbbbbbbbbbbbbbbbbbbbbbbbbbbbbbbbbbbbbbbbbbbbbbbba
abbbbbbbbbbbbbbbbbbbbbbbbbbbbbbbbbbbbbbbbbbbbbbbbbbbbbbbbbaawwBAAaaaaaaaaaaaaaaaaabbbbbbbbbbbbbbbbbbbbbbbbbbbbbbbbbbbbbbbbbba
abaaaaaaaaaaaaaaaaaaaaaaaaaaaaaaaaaaaaaaaaaaaaaaaaaaaaaaaaaaCwBADaaaaaaaaaaaaaaaaabbbbbbbbbbbbbbbbbbbbbbbbbbbbbbbbbbbbbbbbbba
aaaEEFFFEEEFFFEEEEEEFFEEEEEEEEGEECCHIHJJJJJJIIIJJIIJCCKwwwCCKBwBDaaaaaaaaaaaaaaaaabbbbbbbbbbbbbbbbbbbbbbbbbbbbbbbbbbbbbbbbbba
aFFEFFFEEEEFFEEEEEEEEFEEFFFFEEGCCCCJJJIEEBEBIBBBBKBJBBJBwJJBwwDBBaaaaaaaaaaaaaaaabbbbbbbbbbbbbbbbbbbbbbbbbbbbbbbbbbbbbbbbbbba
aFFEFFFEEEEEFEEFFFEEEEEEEEFFEELECECCCJHEBEEJBBJBJBJJBJJwwJDwwwDDaaaaaaaaaaaaaaaabbbbbbbbbbbbbbbbbbbbbbbbbbbbbbbbbbbbbbbbbbbba
aFEEEFEEEEEEFEEFFFFEEEEEEEEEEEGCCEEECCIBBEIJIJJIJICCCCCwDDDDwwaaaabbaaaaaaaabbbbbbbbbbbbbbbbbbbbbbbbbbbbbbbbbbbbbbbbbbbbbbbba
aFEEEFEEEEEEEEEFFFFFEEEEFEEEEEaaaaaEECCHHEEEaaaaaaaaaaaaaaaawwaaaabbbbbbbbbbbbbbbbbbbbbbbbbbbbbbbbbbbbbbbbbbbbbbbbbbbbbbbbbba
aEEEEEEEEEEEEEEFFFEEEEEEFEFEFFEaaaMMMMMNMMMMabbbbbbbbbbbbbaaDwaaaabbbbbbbbbbbbbbbbbbbbbbbbbbbbbbbbbbbbbbbbbbbbbbbbbbbbbbbbbba
aEFEEEEEFFEEEEEEEEEEFEEEFFFEFFEEaaMOOOOPQQOMGGGGbbbbbbbbbbbaDaabbbbbbbbbbbbbbbbbbbbbbbbbbbbbbbbbbbbbbbbbbbbbbbbbbbbbbbbbbbbba
aEFFEEEFFFEEEEEEEEEFFEEEFEEEEEEEFaMOOQQOOQPRCSTGbbbbbbbbbbbaaabbbbbbbbbbbbbbbbbbbbbbbbbbbbbbbbbbbbbbbbbbbbbbbbbbbbbbbbbbbbbba
aEFFEEFFFFEEEEEEEEEEEEEEFEEEEEEFFaMQQQOOOQOMCCJGbbbbbbbbbbbbbbbbbbbbbbbbbbbbbbbbbbbbbbbbbbbbbbbbbbbbbbbbbbbbbbbbbbbbbbbbbbbba
aEFFEEEEEFEEEEEFEEEEEEEEEEEFEEEEaaMQOQOOQQOMGUGGbbbbbbbbbbbbbbbbbbbbbbbbbbbbbbbbbbbbbbbbbbbbbbbbbbbbbbbbbbbbbbbbbbbbbbbbbbbba
aEFFEEEEEEEEEEEFFEEFFEEEEEEFEEEaaaMOOOOQQOPRKCCGbbbbbbbbbbbbbbbbbbbbbbbbbbbbbbbbbbbbbbbbbbbbbbbbbbbbbbbbbbbbbbbbbbbbbbbbbbbba
aEFEEEEEEEEEFFEFFFFFFEEEEEFEEEEaaaMQOOQOOOOMTSKGbbbbbbbbbbbbbbbbbbbbbbbbbbbbbbbbbbbbbbbbbbbbbbbbbbbbbbbbbbbbbbbbbbbbbbbbbbbba
aEEEEEEEEEEFFFEFFEEEEEEEEEFEEEEaaaMMMMMMMMMMGGGGbbbbbbbbbbbbbbbbbbbbbbbbbbbbbbbbbbbbbbbbbbbbbbbbbbbbbbbbbbbbbbbbbbbbbbbbbbbba
aEEEEEEEEEEFFEEFEEEEEEFEEFFEEEEFaaaaabbbbbbbbbbbbbbbbbbbbbbbbbbbbbbbbbbbbbbbbbbbbbbbbbbbbbbbbbbbbbbbbbbbbbbbbbbbbbbbbbbbbbbba
aFFEEEFEEEEEFEEFEEEEEFFEEEFEEEEFaaaaabbbbbbbbbbbbbbbbbbbbbbbbbbbbbbbbbbbbbbbbbbbbbbbbbbbbbbbbbbbbbbbbbbbbbbbbbbbbbbbbbbbbbbba
aFFEEEFFEEEEEEEEEEEFFFFEEEEEEEEFFEFEabbbbbbbbbbbbbbbbbbbbbbbbbbbbbbbbbbbbbbbbbbbbbbbbbbbbbbbbbbbbbbbbbbbbbbbbbbbbbbbbbbbbbbba
aEEEEEEEEEEEEEEEEEEEEEEEEEEEEEEEEFFFabbbbbbbbbbbbbbbbbbbbbbbbbbbbbbbbbbbbbbbbbbbbbbbbbbbbbbbbbbbbbbbbbbbbbbbbbbbbbbbbbbbbbbba
aEEEFFEEEEEEEEEFEEEEFEEEEEEEFEEEEEFFabbbbbbbbbbbbbbbbbbbbbbbbbbbbbbbbbbbbbbbbbbbbbbbbbbbbbbbbbbbbbbbbbbbbbbbbbbbbbbbbbbbbbbba
aEEEFFFEEEEEFEFFEEEFFFEEEEEEFEEEEEFEabbbbbbbbbbbbbbbbbbbbbbbbbbbbbbbbbbbbbbbbbbbbbbbbbbbbbbbbbbbbbbbbbbbbbbbbbbbbbbbbbbbbbbba
aEEEFFFEEEEEFFFFFEEFFEEEEEEFFEEEEEEEabbbbbbbbbbbbbbbbbbbbbbbbbbbbbbbbbbbbbbbbbbbbbbbbbbbbbbbbbbbbbbbbbbbbbbbbbbbbbbbbbbbbbbba
aEEFFFFEEEEFFEEEEEFFEEEEEEEFFEEEEEEaabbbbbbbbbbbbbbbbbbbbbbbbbbbbbbbbbbbbbbbbbbbbbbbbbbbbbbbbbbbbbbbbbbbbbbbbbbbbbbbbbbbbbbba
aEEFFEEEEEEFFEEEEEFFEEEEEEEEEEEFEEEabbbbbbbbbbbbbbbbbbbbbbbbbbbbbbbbbbbbbbbbbbbbbbbbbbbbbbbbbbbbbbbbbbbbbbbbbbbbbbbbbbbbbbbba
aEEFFEEEEEEEFEEEEEEFEEEEEEEEEEEFEEEabbbbbbbbbbbbbbbbbbbbbbbbbbbbbbbbbbbbbbbbbbbbbbbbbbbbbbbbbbbbbbbbbbbbbbbbbbbbbbbbbbbbbbbba
aEEEEEEEEEEEEEEEEFFEEEEEFFEEEEFFFEEabbbbbbbbbbbbbbbbbbbbbbbbbbbbbbbbbbbbbbbbbbbbbbbbbbbbbbbbbbbbbbbbbbbbbbbbbbbbbbbbbbbbbbbba
aFEEEEEEEFFEEEEEFFFEEEEFFFEEEEFFFEEabbbbbbbbbbbbbbbbbbbbbbbbbbbbbbbbbbbbbbbbbbbbbbbbbbbbbbbbbbbbbbbbbbbbbbbbbbbbbbbbbbbbbbbba
aFFFEEEFFFFFFEEEEFFEEEEEEEEEEEEFEEEabbbbbbbbbbbbbbbbbbbbbbbbbbbbbbbbbbbbbbbbbbbbbbbbbbbbbbbbbbbbbbbbbbbbbbbbbbbbbbbbbbbbbbbba
aaaaaaaaaaaaaaaaaaaaaaaaaaaaaaaaaaaaaaaaaaaaaaaaaaaaaaaaaaaaaaaaaaaaaaaaaaaaaaaaaaaaaaaaaaaaaaaaaaaaaaaaaaaaaaaaaaaaaaaaaaaaa
"}
