//MAP CONVERTED BY dmm2tgm.py THIS HEADER COMMENT PREVENTS RECONVERSION, DO NOT REMOVE
"a" = (
/turf/template_noop,
/area/template_noop)
"b" = (
/obj/structure/shuttle/engine/propulsion{
	dir = 1
	},
/obj/effect/turf_decal/stripes/line{
	dir = 1
	},
/turf/open/floor/plating/airless,
/area/shuttle/arrival)
"c" = (
/obj/docking_port/mobile/arrivals{
	dir = 2;
	dwidth = 4;
	height = 17;
	name = "delta arrivals shuttle";
	width = 9
	},
/turf/closed/wall/r_wall,
/area/shuttle/arrival)
"e" = (
/obj/structure/window/reinforced,
/obj/structure/shuttle/engine/heater{
	dir = 1
	},
/obj/effect/turf_decal/stripes/line{
	dir = 1
	},
/turf/open/floor/plating/airless,
/area/shuttle/arrival)
"h" = (
/obj/effect/spawner/structure/window/reinforced,
/turf/open/floor/plating,
/area/shuttle/arrival)
"i" = (
/obj/item/clothing/suit/hazardvest{
	desc = "A high-visibility lifejacket complete with whistle and slot for oxygen tanks.";
	name = "emergency lifejacket"
	},
/obj/item/clothing/suit/hazardvest{
	desc = "A high-visibility lifejacket complete with whistle and slot for oxygen tanks.";
	name = "emergency lifejacket"
	},
/obj/item/clothing/suit/hazardvest{
	desc = "A high-visibility lifejacket complete with whistle and slot for oxygen tanks.";
	name = "emergency lifejacket"
	},
/obj/item/clothing/suit/hazardvest{
	desc = "A high-visibility lifejacket complete with whistle and slot for oxygen tanks.";
	name = "emergency lifejacket"
	},
/obj/item/clothing/suit/hazardvest{
	desc = "A high-visibility lifejacket complete with whistle and slot for oxygen tanks.";
	name = "emergency lifejacket"
	},
/obj/item/tank/internals/emergency_oxygen{
	pixel_x = 3
	},
/obj/item/tank/internals/emergency_oxygen{
	pixel_x = 3
	},
/obj/item/tank/internals/emergency_oxygen{
	pixel_x = 3
	},
/obj/item/tank/internals/emergency_oxygen{
	pixel_x = 3
	},
/obj/item/tank/internals/emergency_oxygen{
	pixel_x = 3
	},
/obj/item/clothing/mask/breath{
	pixel_x = -3;
	pixel_y = -3
	},
/obj/item/clothing/mask/breath{
	pixel_x = -3;
	pixel_y = -3
	},
/obj/item/clothing/mask/breath{
	pixel_x = -3;
	pixel_y = -3
	},
/obj/item/clothing/mask/breath{
	pixel_x = -3;
	pixel_y = -3
	},
/obj/item/clothing/mask/breath{
	pixel_x = -3;
	pixel_y = -3
	},
/obj/item/clothing/head/hardhat/orange{
	name = "protective hat";
	pixel_y = 9
	},
/obj/item/clothing/head/hardhat/orange{
	name = "protective hat";
	pixel_y = 9
	},
/obj/item/clothing/head/hardhat/orange{
	name = "protective hat";
	pixel_y = 9
	},
/obj/item/clothing/head/hardhat/orange{
	name = "protective hat";
	pixel_y = 9
	},
/obj/item/clothing/head/hardhat/orange{
	name = "protective hat";
	pixel_y = 9
	},
/obj/structure/closet/crate/internals,
/obj/effect/turf_decal/bot,
/turf/open/floor/iron,
/area/shuttle/arrival)
"j" = (
/obj/effect/turf_decal/delivery,
/obj/structure/closet/wardrobe/mixed,
/turf/open/floor/iron,
/area/shuttle/arrival)
"k" = (
/obj/structure/table/reinforced,
/obj/item/storage/toolbox/emergency,
/obj/effect/turf_decal/bot,
/turf/open/floor/iron,
/area/shuttle/arrival)
"l" = (
/obj/structure/table/reinforced,
/obj/structure/extinguisher_cabinet{
	pixel_y = 28
	},
/obj/item/storage/firstaid/regular{
	pixel_x = 3;
	pixel_y = 3
	},
/obj/item/storage/firstaid/regular,
/obj/effect/turf_decal/bot,
/turf/open/floor/iron,
/area/shuttle/arrival)
"m" = (
/obj/structure/table/reinforced,
/obj/machinery/cell_charger,
/obj/effect/turf_decal/bot,
/turf/open/floor/iron,
/area/shuttle/arrival)
"n" = (
/obj/effect/turf_decal/stripes/line{
	dir = 8
	},
/obj/effect/turf_decal/stripes/line{
	dir = 4
	},
/obj/machinery/door/airlock/maintenance{
	dir = 4;
	name = "Arrival Shuttle Airlock"
	},
/turf/open/floor/iron/white,
/area/shuttle/arrival)
"o" = (
/obj/effect/turf_decal/tile/neutral{
	dir = 1
	},
/obj/effect/turf_decal/tile/neutral{
	dir = 8
	},
/turf/open/floor/iron{
	heat_capacity = 1e+006
	},
/area/shuttle/arrival)
"p" = (
/obj/effect/turf_decal/tile/neutral{
	dir = 1
	},
/obj/effect/turf_decal/tile/neutral,
/obj/effect/turf_decal/tile/neutral{
	dir = 4
	},
/obj/effect/turf_decal/tile/neutral{
	dir = 8
	},
/turf/open/floor/iron,
/area/shuttle/arrival)
"q" = (
/obj/effect/turf_decal/tile/neutral,
/obj/effect/turf_decal/tile/neutral{
	dir = 4
	},
/turf/open/floor/iron,
/area/shuttle/arrival)
"s" = (
/obj/machinery/holopad,
/obj/effect/turf_decal/bot,
/obj/machinery/light/small/directional/south,
/turf/open/floor/iron,
/area/shuttle/arrival)
"u" = (
/obj/structure/chair/comfy/shuttle{
	dir = 4
	},
/obj/effect/turf_decal/bot,
/turf/open/floor/iron,
/area/shuttle/arrival)
"v" = (
/obj/structure/chair/comfy/shuttle{
	dir = 8
	},
/obj/effect/turf_decal/bot,
/turf/open/floor/iron,
/area/shuttle/arrival)
"x" = (
/obj/structure/flora/ausbushes/grassybush,
/obj/structure/flora/ausbushes/lavendergrass,
/obj/structure/flora/ausbushes/ppflowers,
/obj/structure/flora/ausbushes/sunnybush,
/obj/effect/spawner/structure/window/reinforced,
/turf/open/floor/grass,
/area/shuttle/arrival)
"y" = (
/obj/structure/flora/ausbushes/grassybush,
/obj/structure/flora/ausbushes/lavendergrass,
/obj/structure/flora/ausbushes/ywflowers,
/obj/structure/flora/ausbushes/fernybush,
/obj/effect/spawner/structure/window/reinforced,
/turf/open/floor/grass,
/area/shuttle/arrival)
"z" = (
/turf/closed/wall/r_wall,
/area/shuttle/arrival)
"A" = (
/obj/item/kirbyplants{
	icon_state = "plant-21"
	},
/obj/effect/turf_decal/tile/neutral{
	dir = 1
	},
/obj/effect/turf_decal/tile/neutral{
	dir = 8
	},
/turf/open/floor/iron{
	heat_capacity = 1e+006
	},
/area/shuttle/arrival)
"B" = (
/obj/structure/table/reinforced,
/obj/item/clipboard,
/obj/effect/turf_decal/delivery,
/turf/open/floor/iron,
/area/shuttle/arrival)
"D" = (
/obj/structure/table/reinforced,
/obj/item/folder,
/obj/item/storage/dice,
/obj/effect/turf_decal/delivery,
/turf/open/floor/iron,
/area/shuttle/arrival)
"E" = (
/obj/item/kirbyplants{
	icon_state = "plant-21"
	},
/obj/effect/turf_decal/tile/neutral,
/obj/effect/turf_decal/tile/neutral{
	dir = 4
	},
/turf/open/floor/iron,
/area/shuttle/arrival)
"F" = (
/obj/effect/turf_decal/tile/neutral{
	dir = 1
	},
/obj/effect/turf_decal/tile/neutral,
/obj/effect/turf_decal/tile/neutral{
	dir = 4
	},
/obj/effect/turf_decal/tile/neutral{
	dir = 8
	},
/obj/machinery/vending/wallmed/directional/north{
	use_power = 0;
	pixel_y = 28
	},
/obj/machinery/light/small/directional/north,
/turf/open/floor/iron,
/area/shuttle/arrival)
"G" = (
/obj/structure/table/reinforced,
/obj/item/paper_bin,
/obj/item/pen,
/obj/effect/turf_decal/bot,
/obj/item/radio/intercom/directional/west,
/turf/open/floor/iron,
/area/shuttle/arrival)
"H" = (
/obj/structure/closet/wardrobe/black,
/obj/effect/turf_decal/tile/neutral,
/obj/effect/turf_decal/tile/neutral{
	dir = 8
	},
/turf/open/floor/iron,
/area/shuttle/arrival)
"I" = (
/obj/structure/closet/wardrobe/grey,
/obj/effect/turf_decal/tile/blue,
/turf/open/floor/iron,
/area/shuttle/arrival)
"J" = (
/obj/effect/turf_decal/tile/blue,
/obj/effect/turf_decal/tile/blue{
	dir = 8
	},
/turf/open/floor/iron,
/area/shuttle/arrival)
"K" = (
/obj/structure/closet/wardrobe/yellow,
/obj/effect/turf_decal/tile/blue{
	dir = 8
	},
/turf/open/floor/iron,
/area/shuttle/arrival)
"L" = (
/obj/structure/closet/wardrobe/grey,
/obj/effect/turf_decal/tile/neutral{
	dir = 1
	},
/obj/effect/turf_decal/tile/neutral,
/obj/effect/turf_decal/tile/neutral{
	dir = 4
	},
/obj/effect/turf_decal/tile/neutral{
	dir = 8
	},
/turf/open/floor/iron,
/area/shuttle/arrival)
"M" = (
/obj/structure/table/reinforced,
/obj/item/storage/briefcase{
	pixel_x = 3;
	pixel_y = 3
	},
/obj/item/storage/secure/briefcase,
/obj/effect/turf_decal/bot,
/turf/open/floor/iron,
/area/shuttle/arrival)
"O" = (
/obj/effect/turf_decal/stripes/line,
/obj/effect/turf_decal/stripes/line{
	dir = 1
	},
/obj/machinery/door/airlock/maintenance{
	name = "Arrival Shuttle Airlock"
	},
/turf/open/floor/iron,
/area/shuttle/arrival)
"Q" = (
/obj/machinery/light/small/directional/north,
/obj/effect/turf_decal/tile/blue{
	dir = 1
	},
/obj/effect/turf_decal/tile/blue{
	dir = 8
	},
/turf/open/floor/iron,
/area/shuttle/arrival)
"R" = (
/obj/structure/chair/office,
/obj/effect/turf_decal/tile/blue{
	dir = 1
	},
/obj/effect/turf_decal/tile/blue{
	dir = 4
	},
/turf/open/floor/iron,
/area/shuttle/arrival)
"S" = (
/obj/machinery/light/small/directional/north,
/obj/effect/turf_decal/tile/blue,
/obj/effect/turf_decal/tile/blue{
	dir = 4
	},
/turf/open/floor/iron,
/area/shuttle/arrival)
"U" = (
/obj/machinery/computer{
	dir = 1;
	name = "Shuttle computer"
	},
/obj/effect/turf_decal/tile/blue{
	dir = 1
	},
/obj/effect/turf_decal/tile/blue,
/obj/effect/turf_decal/tile/blue{
	dir = 4
	},
/obj/effect/turf_decal/tile/blue{
	dir = 8
	},
/turf/open/floor/iron,
/area/shuttle/arrival)
"V" = (
/obj/machinery/computer{
	dir = 1;
	name = "Shuttle computer"
	},
/obj/effect/turf_decal/tile/blue,
/obj/effect/turf_decal/tile/blue{
	dir = 8
	},
/turf/open/floor/iron,
/area/shuttle/arrival)

(1,1,1) = {"
a
z
z
z
n
z
h
h
h
h
z
n
z
z
a
a
a
"}
(2,1,1) = {"
b
z
z
i
o
A
u
u
u
u
A
o
G
z
a
a
a
"}
(3,1,1) = {"
b
e
h
j
p
p
p
p
p
p
p
p
H
z
z
h
z
"}
(4,1,1) = {"
b
e
h
k
p
p
v
v
v
v
B
p
I
z
Q
U
h
"}
(5,1,1) = {"
c
z
z
l
p
s
z
x
y
x
z
F
J
O
R
V
h
"}
(6,1,1) = {"
b
e
h
m
p
p
u
u
u
u
D
p
K
z
S
U
h
"}
(7,1,1) = {"
b
e
h
j
p
p
p
p
p
p
p
p
L
z
z
h
z
"}
(8,1,1) = {"
b
z
z
i
q
E
v
v
v
v
E
q
M
z
a
a
a
"}
(9,1,1) = {"
a
z
z
z
n
z
h
h
h
h
z
n
z
z
a
a
a
"}
