//MAP CONVERTED BY dmm2tgm.py THIS HEADER COMMENT PREVENTS RECONVERSION, DO NOT REMOVE
"a" = (
/obj/effect/turf_decal/stripes/line{
	dir = 6
	},
/obj/effect/turf_decal/stripes/corner{
	dir = 1
	},
/obj/machinery/light/small/directional/south,
/turf/open/floor/iron,
/area/shuttle/supply)
"b" = (
/obj/effect/decal/cleanable/dirt,
/obj/effect/turf_decal/stripes/line{
	dir = 9
	},
/obj/machinery/button/door/directional/west{
	id = "cargounload";
	name = "Loading Doors";
	pixel_y = 25;
	pixel_x = -9
	},
/obj/machinery/light/small/directional/north,
/turf/open/floor/iron,
/area/shuttle/supply)
"c" = (
/obj/effect/turf_decal/stripes/line{
	dir = 1
	},
/turf/open/floor/iron,
/area/shuttle/supply)
"e" = (
/obj/effect/decal/cleanable/dirt,
/obj/effect/turf_decal/stripes/line{
	dir = 1
	},
/turf/open/floor/iron,
/area/shuttle/supply)
"f" = (
/obj/effect/turf_decal/stripes/line{
	dir = 5
	},
/obj/machinery/light/small/directional/north,
/turf/open/floor/iron,
/area/shuttle/supply)
"g" = (
/obj/effect/decal/cleanable/dirt,
/obj/effect/turf_decal/stripes/line{
	dir = 8
	},
/turf/open/floor/iron,
/area/shuttle/supply)
"h" = (
/obj/effect/turf_decal/bot,
/turf/open/floor/iron,
/area/shuttle/supply)
"i" = (
/obj/effect/decal/cleanable/dirt,
/obj/effect/turf_decal/bot,
/turf/open/floor/iron,
/area/shuttle/supply)
"j" = (
/obj/effect/decal/cleanable/dirt,
/obj/effect/turf_decal/stripes/line{
	dir = 4
	},
/turf/open/floor/iron,
/area/shuttle/supply)
"k" = (
/turf/closed/wall/r_wall,
/area/shuttle/supply)
"l" = (
/obj/effect/decal/cleanable/oil,
/obj/effect/turf_decal/bot,
/turf/open/floor/iron,
/area/shuttle/supply)
"m" = (
/obj/effect/turf_decal/stripes/line{
	dir = 4
	},
/turf/open/floor/iron,
/area/shuttle/supply)
"n" = (
/obj/machinery/door/airlock/shuttle{
	name = "Supply Shuttle Airlock";
	req_access_txt = "31"
	},
/obj/effect/decal/cleanable/dirt,
/obj/docking_port/mobile/supply{
	dir = 4;
	dwidth = 4
	},
/turf/open/floor/plating,
/area/shuttle/supply)
"o" = (
/obj/effect/turf_decal/stripes/line{
	dir = 8
	},
/turf/open/floor/iron,
/area/shuttle/supply)
"p" = (
/obj/effect/turf_decal/stripes/line{
	dir = 8
	},
/obj/machinery/button/door/directional/west{
	id = "cargoload";
	name = "Loading Doors";
	pixel_y = -8
	},
/turf/open/floor/iron,
/area/shuttle/supply)
"q" = (
/obj/effect/decal/cleanable/dirt,
/obj/effect/turf_decal/stripes/line{
	dir = 10
	},
/obj/effect/turf_decal/stripes/corner{
	dir = 4
	},
/obj/machinery/light/small/directional/south,
/turf/open/floor/iron,
/area/shuttle/supply)
"r" = (
/obj/machinery/door/airlock/shuttle{
	name = "Supply Shuttle Airlock";
	req_access_txt = "31"
	},
/obj/effect/decal/cleanable/dirt,
/turf/open/floor/plating,
/area/shuttle/supply)
"t" = (
/obj/effect/decal/cleanable/dirt,
/obj/effect/turf_decal/stripes/corner,
/turf/open/floor/iron,
/area/shuttle/supply)
"u" = (
/obj/effect/decal/cleanable/dirt,
/obj/effect/turf_decal/stripes/line,
/turf/open/floor/iron,
/area/shuttle/supply)
"v" = (
/obj/effect/turf_decal/stripes/line,
/turf/open/floor/iron,
/area/shuttle/supply)
"w" = (
/obj/effect/turf_decal/stripes/corner{
	dir = 8
	},
/turf/open/floor/iron,
/area/shuttle/supply)
"x" = (
/obj/effect/decal/cleanable/dirt,
/obj/effect/turf_decal/delivery,
/obj/effect/turf_decal/stripes/line,
/turf/open/floor/iron,
/area/shuttle/supply)
"y" = (
/obj/effect/turf_decal/delivery,
/obj/effect/turf_decal/stripes/line,
/turf/open/floor/iron,
/area/shuttle/supply)
"z" = (
/obj/structure/window/reinforced{
	dir = 1
	},
/obj/structure/shuttle/engine/heater,
/obj/effect/turf_decal/stripes/line,
/turf/open/floor/plating/airless,
/area/shuttle/supply)
"A" = (
/obj/structure/window/reinforced{
	dir = 1
	},
/obj/structure/shuttle/engine/heater,
/obj/effect/decal/cleanable/dirt,
/obj/effect/turf_decal/stripes/line,
/turf/open/floor/plating/airless,
/area/shuttle/supply)
"B" = (
/turf/template_noop,
/area/template_noop)
"C" = (
/obj/structure/shuttle/engine/propulsion/burst/left,
/obj/effect/turf_decal/stripes/line,
/turf/open/floor/plating/airless,
/area/shuttle/supply)
"D" = (
/obj/structure/shuttle/engine/propulsion,
/obj/effect/turf_decal/stripes/line,
/turf/open/floor/plating/airless,
/area/shuttle/supply)
"E" = (
/obj/structure/shuttle/engine/propulsion/burst/right,
/obj/effect/turf_decal/stripes/line,
/turf/open/floor/plating/airless,
/area/shuttle/supply)

(1,1,1) = {"
k
k
k
k
n
k
r
k
k
k
k
B
"}
(2,1,1) = {"
k
b
g
g
o
p
o
o
t
q
k
C
"}
(3,1,1) = {"
k
c
h
l
h
h
h
i
u
x
z
D
"}
(4,1,1) = {"
k
e
i
i
i
h
i
h
v
x
A
D
"}
(5,1,1) = {"
k
e
i
h
h
h
h
h
v
y
A
D
"}
(6,1,1) = {"
k
f
j
m
j
m
m
j
w
a
k
E
"}
(7,1,1) = {"
k
k
k
k
k
k
k
k
k
k
k
B
"}
