//MAP CONVERTED BY dmm2tgm.py THIS HEADER COMMENT PREVENTS RECONVERSION, DO NOT REMOVE
"a" = (
/obj/effect/turf_decal/siding/wideplating/dark,
/obj/machinery/door/airlock/maintenance,
/turf/open/floor/iron,
/area/shuttle/escape)
"c" = (
/obj/effect/turf_decal/tile/red/half{
	dir = 4
	},
/turf/open/floor/iron/dark/side{
	dir = 4
	},
/area/shuttle/escape)
"f" = (
/obj/effect/turf_decal/delivery{
	color = "#801000"
	},
/obj/machinery/door/airlock/maintenance,
/turf/open/floor/iron/dark,
/area/shuttle/escape)
"h" = (
/obj/structure/lattice/catwalk,
/obj/structure/fans/tiny,
/obj/machinery/door/poddoor/shutters/preopen{
	id = "hungus"
	},
/turf/open/floor/plating,
/area/shuttle/escape)
"i" = (
/obj/effect/turf_decal/siding/wideplating/dark{
	dir = 1
	},
/turf/open/floor/iron/dark/side{
	dir = 4
	},
/area/shuttle/escape)
"j" = (
/obj/structure/chair/comfy/shuttle{
	dir = 1
	},
/obj/effect/turf_decal/bot{
	color = "#FF0000"
	},
/turf/open/floor/iron/dark,
/area/shuttle/escape)
"k" = (
/obj/effect/spawner/structure/window/reinforced,
/turf/open/floor/low_wall/reinforced,
/area/shuttle/escape)
"l" = (
/obj/effect/turf_decal/tile/red/anticorner{
	dir = 4
	},
/turf/open/floor/iron/dark/side{
	dir = 5
	},
/area/shuttle/escape)
"n" = (
/obj/structure/chair/comfy/shuttle{
	dir = 1
	},
/obj/effect/turf_decal/bot{
	color = "#FF0000"
	},
/turf/open/floor/iron/dark/side,
/area/shuttle/escape)
"o" = (
/obj/machinery/computer/emergency_shuttle,
/obj/effect/turf_decal/tile/blue{
	dir = 1
	},
/obj/effect/turf_decal/tile/blue,
/obj/machinery/light/small/directional/north,
/turf/open/floor/iron,
/area/shuttle/escape)
"p" = (
/obj/structure/chair/comfy/shuttle{
	dir = 1
	},
/obj/effect/turf_decal/bot{
	color = "#FF0000"
	},
/obj/effect/turf_decal/siding/wideplating/dark/corner{
	dir = 1
	},
/turf/open/floor/iron/dark,
/area/shuttle/escape)
"r" = (
/obj/effect/turf_decal/tile/blue{
	dir = 8
	},
/obj/effect/turf_decal/tile/blue{
	dir = 1
	},
/obj/structure/chair/comfy/shuttle{
	dir = 1
	},
/turf/open/floor/iron,
/area/shuttle/escape)
"t" = (
/turf/open/floor/iron/dark/side,
/area/shuttle/escape)
"v" = (
/obj/machinery/computer/communications,
/obj/effect/turf_decal/tile/blue{
	dir = 4
	},
/obj/effect/turf_decal/tile/blue{
	dir = 8
	},
/obj/machinery/light/small/directional/north,
/turf/open/floor/iron,
/area/shuttle/escape)
"w" = (
/obj/structure/lattice,
/turf/open/floor/plating,
/area/shuttle/escape)
"B" = (
/obj/structure/chair/comfy/shuttle{
	dir = 1
	},
/obj/effect/turf_decal/bot{
	color = "#FF0000"
	},
/obj/effect/turf_decal/siding/wideplating/dark/corner{
	dir = 4
	},
/turf/open/floor/iron/dark,
/area/shuttle/escape)
"C" = (
/obj/structure/lattice/catwalk,
/obj/structure/fans/tiny,
/obj/machinery/door/poddoor/shutters/preopen{
	id = "hungus"
	},
/obj/docking_port/mobile/emergency{
	dir = 1;
	name = "baluarte emergency shuttle"
	},
/turf/open/floor/plating,
/area/shuttle/escape)
"E" = (
/obj/structure/table/reinforced,
/obj/item/storage/firstaid/morango{
	pixel_y = 12;
	pixel_x = 5
	},
/obj/machinery/light/small/directional/east,
/turf/open/floor/iron/dark,
/area/shuttle/escape)
"F" = (
/obj/effect/turf_decal/tile/blue,
/obj/effect/turf_decal/tile/blue{
	dir = 4
	},
/obj/structure/chair/comfy/shuttle{
	dir = 1
	},
/turf/open/floor/iron,
/area/shuttle/escape)
"I" = (
/turf/template_noop,
/area/shuttle/escape)
"K" = (
/obj/machinery/light/small/directional/west,
/turf/open/floor/iron/dark,
/area/shuttle/escape)
"L" = (
/obj/effect/turf_decal/tile/red/half{
	dir = 8
	},
/turf/open/floor/iron/dark/side{
	dir = 8
	},
/area/shuttle/escape)
"M" = (
/turf/closed/wall/r_wall,
/area/shuttle/escape)
"N" = (
/obj/item/kirbyplants/photosynthetic,
/obj/effect/turf_decal/siding/wideplating/dark{
	dir = 4
	},
/turf/open/floor/iron/dark,
/area/shuttle/escape)
"P" = (
/obj/effect/turf_decal/siding/wideplating/dark{
	dir = 1
	},
/turf/open/floor/iron/dark/side{
	dir = 8
	},
/area/shuttle/escape)
"R" = (
/turf/open/floor/iron/dark/side{
	dir = 8
	},
/area/shuttle/escape)
"T" = (
/turf/open/floor/iron/dark/side{
	dir = 4
	},
/area/shuttle/escape)
"V" = (
/obj/item/kirbyplants/photosynthetic,
/turf/open/floor/iron/dark,
/area/shuttle/escape)
"X" = (
/obj/item/kirbyplants/photosynthetic,
/obj/machinery/button/door/directional/west{
	id = "hungus";
	pixel_x = -9;
	pixel_y = 25
	},
/obj/effect/turf_decal/siding/wideplating/dark{
	dir = 8
	},
/turf/open/floor/iron/dark,
/area/shuttle/escape)
"Y" = (
/obj/effect/turf_decal/tile/red/anticorner{
	dir = 1
	},
/turf/open/floor/iron/dark/side{
	dir = 9
	},
/area/shuttle/escape)

(1,1,1) = {"
I
I
I
M
M
k
k
M
k
k
M
M
I
"}
(2,1,1) = {"
M
M
M
M
N
B
j
K
n
j
V
M
M
"}
(3,1,1) = {"
M
o
r
a
w
i
T
T
t
Y
L
f
h
"}
(4,1,1) = {"
M
v
F
a
w
P
R
R
t
l
c
f
C
"}
(5,1,1) = {"
M
M
M
M
X
p
j
E
n
j
V
M
M
"}
(6,1,1) = {"
I
I
I
M
M
k
k
M
k
k
M
M
I
"}
