"a" = (/turf/open/floor/plating/polovich/kapec,/area/shuttle/escape)
"b" = (/obj/structure/railing{dir = 4},/turf/open/floor/plating/polovich/kapec,/area/shuttle/escape)
"c" = (/obj/structure/railing,/turf/open/floor/plating/polovich/kapec,/area/shuttle/escape)
"d" = (/obj/structure/railing{dir = 4},/obj/structure/railing,/turf/open/floor/plating/polovich/kapec,/area/shuttle/escape)
"e" = (/obj/structure/railing{dir = 8},/turf/open/floor/plating/polovich/kapec,/area/shuttle/escape)
"f" = (/obj/structure/railing,/obj/structure/railing{dir = 8},/turf/open/floor/plating/polovich/kapec,/area/shuttle/escape)
"g" = (/obj/structure/railing{dir = 8},/obj/structure/railing{dir = 1},/turf/open/floor/plating/polovich/kapec,/area/shuttle/escape)
"h" = (/obj/structure/railing{dir = 1},/turf/open/floor/plating/polovich/kapec,/area/shuttle/escape)
"i" = (/obj/structure/railing{dir = 4},/obj/structure/railing{dir = 1},/turf/open/floor/plating/polovich/kapec,/area/shuttle/escape)
"j" = (/turf/open/floor/plating/polovich/kapec/two,/area/shuttle/escape)
"k" = (/obj/structure/chair/wood,/turf/open/floor/plating/polovich/kapec,/area/shuttle/escape)
"l" = (/obj/structure/chair/wood{dir = 4},/turf/open/floor/plating/polovich/kapec,/area/shuttle/escape)
"m" = (/obj/structure/table/reinforced,/obj/item/reagent_containers/food/drinks/bottle/whiskey,/turf/open/floor/plating/polovich/kapec,/area/shuttle/escape)
"n" = (/obj/structure/chair/wood{dir = 8},/turf/open/floor/plating/polovich/kapec,/area/shuttle/escape)
"o" = (/obj/structure/chair/wood{dir = 1},/turf/open/floor/plating/polovich/kapec,/area/shuttle/escape)
"p" = (/obj/structure/table/reinforced,/obj/item/reagent_containers/food/drinks/bottle/wine,/turf/open/floor/plating/polovich/kapec,/area/shuttle/escape)
"q" = (/obj/structure/table/reinforced,/obj/item/reagent_containers/food/drinks/bottle/whiskey,/obj/item/pizzabox/vegetable,/turf/open/floor/plating/polovich/kapec,/area/shuttle/escape)
"r" = (/obj/structure/table/reinforced,/obj/item/reagent_containers/food/drinks/bottle/wine,/obj/item/pizzabox/pineapple,/turf/open/floor/plating/polovich/kapec,/area/shuttle/escape)
"s" = (/obj/structure/table/reinforced,/obj/item/reagent_containers/food/drinks/bottle/whiskey,/obj/item/pizzabox/mushroom,/turf/open/floor/plating/polovich/kapec,/area/shuttle/escape)
"t" = (/obj/structure/table/reinforced,/obj/item/reagent_containers/food/drinks/bottle/wine,/obj/item/pizzabox/meat,/turf/open/floor/plating/polovich/kapec,/area/shuttle/escape)
"u" = (/obj/structure/village_screamer,/turf/open/floor/plating/polovich/kapec,/area/shuttle/escape)
"v" = (/obj/structure/railing{dir = 8},/turf/open/floor/plating/polovich/kapec/two,/area/shuttle/escape)
"w" = (/obj/structure/railing{dir = 4},/turf/open/floor/plating/polovich/kapec/two,/area/shuttle/escape)
"x" = (/turf/closed/wall/pink_crazy/nocling,/area/shuttle/escape)
"y" = (/obj/structure/reagent_dispensers/watertank/sperm,/turf/open/floor/plating/polovich/kapec,/area/shuttle/escape)
"z" = (/obj/machinery/door/keycard/denominator/podozl/akt/controller{dir = 8},/turf/open/floor/plating/polovich/kapec,/area/shuttle/escape)
"A" = (/obj/structure/lampstand,/turf/open/floor/plating/polovich/kapec,/area/shuttle/escape)
"B" = (/obj/structure/table/reinforced,/obj/item/reagent_containers/food/drinks/soda_cans/lean,/obj/item/gun/ballistic/automatic/remis/g36,/turf/open/floor/plating/polovich/kapec,/area/shuttle/escape)
"C" = (/obj/structure/lampstand,/turf/open/floor/plating/polovich/kapec/two,/area/shuttle/escape)
"D" = (/obj/structure/lampstand/fireholder,/turf/open/floor/plating/polovich/kapec/two,/area/shuttle/escape)
"E" = (/obj/structure/lampstand/fireholder,/turf/open/floor/plating/polovich/kapec,/area/shuttle/escape)

(1,1,1) = {"
ghhhhhhhhhi
exxxxaaayAb
exABxaaaaab
exaazaaayAb
exxxxaaaaab
eAaaAaaaaAb
eaaaaaaaaab
aaaaDjDaaaa
aaaajujaaaa
eAaaDjDaaAb
eaaaajaaaab
eAaaajaaaAb
eaaaEjEaaab
ejjjjjjjjjb
vjkkkkkkkjw
vlqmrpsmtnw
vjooooooojw
eCjjDjDjjCb
fcccccccccd
"}
