"ac" = (/turf/closed/wall/r_wall,/area/shuttle/escape)
"av" = (/obj/effect/turf_decal/siding/wideplating/dark{dir = 1},/obj/effect/turf_decal/tile/blue{dir = 1},/obj/effect/turf_decal/tile/blue{dir = 4},/obj/effect/turf_decal/tile/blue,/turf/open/floor/iron,/area/shuttle/escape)
"aB" = (/obj/structure/flora/ausbushes/grassybush,/obj/structure/flora/ausbushes/lavendergrass,/obj/structure/flora/ausbushes/ywflowers,/obj/structure/flora/ausbushes/fernybush,/obj/structure/window/fulltile,/turf/open/floor/grass,/area/shuttle/escape)
"bh" = (/obj/structure/chair/comfy/shuttle{dir = 8},/obj/effect/turf_decal/bot{color = "#FF0000"},/turf/open/floor/iron,/area/shuttle/escape)
"bI" = (/obj/machinery/door/poddoor/shutters/preopen{id = "chungus3"},/obj/structure/lattice,/turf/open/floor/plating,/area/shuttle/escape)
"cX" = (/obj/structure/table,/obj/machinery/recharger,/obj/effect/turf_decal/siding/wideplating/dark{dir = 10},/obj/machinery/light/small/directional/west,/turf/open/floor/iron,/area/shuttle/escape)
"dQ" = (/obj/structure/chair/comfy/shuttle{dir = 8},/obj/effect/turf_decal/bot{color = "#FF0000"},/obj/machinery/button/door/directional/east{id = "chungus2"},/turf/open/floor/iron,/area/shuttle/escape)
"ed" = (/obj/structure/table,/obj/item/storage/firstaid,/obj/item/crowbar,/obj/effect/turf_decal/siding/wideplating/dark,/obj/effect/turf_decal/tile/blue,/obj/effect/turf_decal/tile/blue{dir = 8},/obj/effect/turf_decal/tile/blue{dir = 4},/turf/open/floor/iron,/area/shuttle/escape)
"eF" = (/turf/open/floor/iron/dark/side{dir = 4},/area/shuttle/escape)
"gL" = (/obj/structure/table/reinforced,/obj/item/storage/briefcase{pixel_x = 3; pixel_y = 3},/obj/item/storage/secure/briefcase,/obj/effect/turf_decal/bot{color = "#FF0000"},/turf/open/floor/iron,/area/shuttle/escape)
"hk" = (/obj/structure/flora/ausbushes/grassybush,/obj/structure/flora/ausbushes/lavendergrass,/obj/structure/flora/ausbushes/ppflowers,/obj/structure/flora/ausbushes/sunnybush,/obj/structure/window/fulltile,/turf/open/floor/grass,/area/shuttle/escape)
"js" = (/obj/effect/turf_decal/tile/blue{dir = 4},/turf/open/floor/iron/dark/side{dir = 1},/area/shuttle/escape)
"jR" = (/obj/machinery/light/small/directional/east,/turf/open/floor/iron/dark/side{dir = 8},/area/shuttle/escape)
"kQ" = (/obj/effect/turf_decal/siding/wideplating/dark/corner{dir = 1},/turf/open/floor/iron/dark/side{dir = 10},/area/shuttle/escape)
"lW" = (/turf/open/floor/iron/dark/side,/area/shuttle/escape)
"ol" = (/obj/machinery/light/small/directional/north,/turf/open/floor/iron/dark/side,/area/shuttle/escape)
"oo" = (/obj/effect/turf_decal/siding/wideplating/dark{dir = 8},/obj/structure/chair/comfy/shuttle{dir = 4},/obj/effect/turf_decal/tile/blue{dir = 1},/obj/effect/turf_decal/tile/blue{dir = 8},/turf/open/floor/iron,/area/shuttle/escape)
"oI" = (/obj/effect/turf_decal/siding/wideplating/dark/corner{dir = 8},/obj/structure/railing/corner{dir = 8; pixel_y = 1},/turf/open/floor/iron/dark/side{dir = 8},/area/shuttle/escape)
"pf" = (/obj/machinery/computer/emergency_shuttle{dir = 8},/obj/effect/turf_decal/tile/blue,/obj/effect/turf_decal/tile/blue{dir = 4},/obj/effect/turf_decal/tile/blue{dir = 8},/turf/open/floor/iron,/area/shuttle/escape)
"pi" = (/obj/effect/turf_decal/siding/wideplating/dark{dir = 8},/obj/effect/turf_decal/tile/blue{dir = 8},/obj/effect/turf_decal/tile/blue{dir = 1},/turf/open/floor/iron,/area/shuttle/escape)
"pq" = (/obj/effect/turf_decal/tile/neutral{dir = 1},/obj/effect/turf_decal/tile/neutral,/obj/effect/turf_decal/tile/neutral{dir = 4},/obj/effect/turf_decal/tile/neutral{dir = 8},/turf/open/floor/iron,/area/shuttle/escape)
"qB" = (/obj/effect/turf_decal/tile/neutral{dir = 4},/obj/effect/turf_decal/tile/neutral,/obj/effect/turf_decal/tile/neutral{dir = 8},/obj/effect/turf_decal/tile/neutral{dir = 1},/obj/effect/turf_decal/siding/wideplating/dark,/turf/open/floor/iron,/area/shuttle/escape)
"qJ" = (/obj/structure/chair/comfy/shuttle{dir = 4},/obj/effect/turf_decal/bot{color = "#FF0000"},/obj/structure/window/reinforced,/obj/machinery/light/small/directional/west,/turf/open/floor/iron,/area/shuttle/escape)
"tb" = (/obj/effect/turf_decal/siding/wideplating/dark{dir = 1},/obj/structure/railing{dir = 1},/obj/item/kirbyplants{icon_state = "plant-21"},/turf/open/floor/iron/dark/side{dir = 4},/area/shuttle/escape)
"tX" = (/obj/machinery/door/poddoor/shutters/preopen{id = "chungus4"},/obj/structure/lattice,/turf/open/floor/plating,/area/shuttle/escape)
"uj" = (/obj/structure/drain,/turf/open/floor/iron,/area/shuttle/escape)
"wo" = (/obj/effect/turf_decal/tile/neutral{dir = 1},/obj/effect/turf_decal/tile/neutral,/obj/effect/turf_decal/tile/neutral{dir = 4},/obj/effect/turf_decal/tile/neutral{dir = 8},/obj/machinery/light/small/directional/west,/turf/open/floor/iron,/area/shuttle/escape)
"wp" = (/obj/machinery/door/airlock/maintenance{name = "train access"},/turf/open/floor/iron/solarpanel,/area/shuttle/escape)
"wD" = (/obj/structure/chair/comfy/shuttle{dir = 8},/obj/effect/turf_decal/bot{color = "#FF0000"},/obj/structure/window/reinforced,/obj/machinery/light/small/directional/east,/turf/open/floor/iron,/area/shuttle/escape)
"xw" = (/obj/effect/turf_decal/tile/neutral{dir = 1},/obj/effect/turf_decal/tile/neutral,/obj/effect/turf_decal/tile/neutral{dir = 4},/obj/effect/turf_decal/tile/neutral{dir = 8},/obj/structure/extinguisher_cabinet/directional/east,/obj/machinery/light/small/directional/east,/turf/open/floor/iron,/area/shuttle/escape)
"xR" = (/obj/structure/extinguisher_cabinet/directional/east,/obj/machinery/computer/communications{dir = 8},/obj/effect/turf_decal/tile/blue,/obj/effect/turf_decal/tile/blue{dir = 4},/obj/effect/turf_decal/tile/blue{dir = 1},/turf/open/floor/iron,/area/shuttle/escape)
"Bc" = (/obj/machinery/vending/wallmed/directional/north{use_power = 0},/turf/open/floor/iron/dark/side,/area/shuttle/escape)
"Bi" = (/obj/structure/chair/comfy/shuttle{dir = 8},/obj/effect/turf_decal/bot{color = "#FF0000"},/obj/machinery/button/door/directional/east{id = "chungus1"},/turf/open/floor/iron,/area/shuttle/escape)
"Bl" = (/obj/effect/turf_decal/tile/neutral{dir = 4},/obj/effect/turf_decal/tile/neutral,/obj/effect/turf_decal/tile/neutral{dir = 1},/obj/effect/turf_decal/tile/neutral{dir = 8},/obj/effect/turf_decal/siding/wideplating/dark{dir = 1},/turf/open/floor/iron,/area/shuttle/escape)
"Cz" = (/obj/structure/chair/comfy/shuttle{dir = 4},/obj/effect/turf_decal/bot{color = "#FF0000"},/turf/open/floor/iron,/area/shuttle/escape)
"DJ" = (/obj/machinery/door/poddoor/shutters/preopen{id = "chungus2"},/obj/structure/lattice,/turf/open/floor/plating,/area/shuttle/escape)
"EG" = (/obj/structure/chair/comfy/shuttle{dir = 8},/obj/effect/turf_decal/bot{color = "#FF0000"},/obj/structure/window/reinforced{dir = 1},/obj/machinery/light/small/directional/east,/turf/open/floor/iron,/area/shuttle/escape)
"Fy" = (/obj/structure/chair/comfy/shuttle{dir = 4},/obj/effect/turf_decal/bot{color = "#FF0000"},/obj/machinery/button/door/directional/west{id = "chungus3"},/turf/open/floor/iron,/area/shuttle/escape)
"Gn" = (/obj/machinery/door/poddoor/shutters/preopen{id = "chungus1"},/obj/structure/lattice,/turf/open/floor/plating,/area/shuttle/escape)
"Hn" = (/obj/structure/closet/wardrobe/mixed,/obj/effect/turf_decal/bot_red/left,/turf/open/floor/iron/dark/side{dir = 4},/area/shuttle/escape)
"HU" = (/obj/structure/chair/comfy/shuttle{dir = 8},/obj/effect/turf_decal/bot{color = "#FF0000"},/obj/structure/window/reinforced{dir = 1},/turf/open/floor/iron,/area/shuttle/escape)
"HY" = (/obj/structure/chair/comfy/shuttle{dir = 4},/obj/effect/turf_decal/bot{color = "#FF0000"},/obj/structure/window/reinforced{dir = 1},/obj/machinery/light/small/directional/west,/turf/open/floor/iron,/area/shuttle/escape)
"Ih" = (/obj/machinery/button/door/directional/west{id = "hungus"; pixel_y = -10},/obj/effect/turf_decal/siding/wideplating/dark{dir = 9},/obj/machinery/light/small/directional/west,/turf/open/floor/iron,/area/shuttle/escape)
"In" = (/obj/effect/turf_decal/tile/neutral{dir = 1},/obj/effect/turf_decal/tile/neutral{dir = 4},/turf/open/floor/iron,/area/shuttle/escape)
"Jg" = (/obj/structure/table/reinforced,/obj/machinery/cell_charger,/obj/effect/turf_decal/bot{color = "#FF0000"},/turf/open/floor/iron,/area/shuttle/escape)
"Kn" = (/obj/structure/closet/wardrobe/mixed,/obj/effect/turf_decal/bot_red/left,/turf/open/floor/iron/dark/side{dir = 8},/area/shuttle/escape)
"Lj" = (/turf/open/floor/iron,/area/shuttle/escape)
"MV" = (/turf/template_noop,/area/shuttle/escape)
"Pa" = (/obj/machinery/door/poddoor/shutters/preopen{id = "hungus"},/obj/structure/lattice/catwalk,/turf/open/floor/iron/solarpanel,/area/shuttle/escape)
"PB" = (/obj/machinery/light/small/directional/south,/turf/open/floor/iron/dark/side{dir = 1},/area/shuttle/escape)
"Qn" = (/turf/open/floor/iron/dark/side{dir = 1},/area/shuttle/escape)
"Qv" = (/obj/structure/chair/comfy/shuttle{dir = 4},/obj/effect/turf_decal/bot{color = "#FF0000"},/obj/machinery/button/door/directional/west{id = "chungus4"},/turf/open/floor/iron,/area/shuttle/escape)
"QE" = (/obj/effect/spawner/structure/window/reinforced,/turf/open/floor/low_wall/reinforced,/area/shuttle/escape)
"Rj" = (/obj/effect/turf_decal/siding/wideplating/dark,/obj/item/kirbyplants{icon_state = "plant-21"},/obj/structure/railing,/turf/open/floor/iron/dark/side{dir = 4},/area/shuttle/escape)
"RW" = (/obj/effect/turf_decal/siding/wideplating/dark/corner{dir = 1},/obj/structure/railing/corner{dir = 1; pixel_y = -1},/turf/open/floor/iron/dark/side{dir = 8},/area/shuttle/escape)
"Sb" = (/obj/effect/turf_decal/siding/wideplating/dark/corner{dir = 8},/turf/open/floor/iron/dark/side{dir = 9},/area/shuttle/escape)
"TJ" = (/obj/structure/table/reinforced,/obj/item/storage/toolbox/emergency,/obj/effect/turf_decal/bot{color = "#FF0000"},/turf/open/floor/iron,/area/shuttle/escape)
"TO" = (/obj/machinery/requests_console{pixel_y = 32},/turf/open/floor/iron/dark/side,/area/shuttle/escape)
"WH" = (/obj/effect/turf_decal/tile/blue,/turf/open/floor/iron/dark/side,/area/shuttle/escape)
"WQ" = (/obj/machinery/door/airlock/maintenance{name = "train access"},/obj/docking_port/mobile/emergency{dir = 2; name = "baluarte emergency shuttle"},/obj/effect/turf_decal/stripes/line,/obj/effect/turf_decal/stripes/line{dir = 1},/turf/open/floor/iron/dark/side{dir = 1},/area/shuttle/escape)
"Zb" = (/obj/effect/turf_decal/tile/neutral{dir = 1},/obj/effect/turf_decal/tile/neutral,/obj/effect/turf_decal/tile/neutral{dir = 4},/obj/effect/turf_decal/tile/neutral{dir = 8},/obj/machinery/light/small/directional/east,/turf/open/floor/iron,/area/shuttle/escape)

(1,1,1) = {"
acWQacacacacacQEQEQEacQEQEQEacMVMVMV
acInJgacHnKnacqJujwDacqJujwDacMVMVMV
QELjxwaceFjRacCzLjBiacCzLjdQacacacac
QELjpqQERjoIacacGnacacacDJacacIhavQE
acwopqwpBlkQollWlWTOolBclWWHPaoopfQE
acwopqwpqBSbPBQnQnQnPBQnQnjsPapixRac
QELjpqQEtbRWacacbIacacactXacaccXedQE
QELjZbaceFjRacFyLjbhacQvLjbhacacacac
acgLTJacaBhkacHYujHUacHYujEGacMVMVMV
acacacacacacacQEQEQEacQEQEQEacMVMVMV
"}
