"b" = (/turf/closed/wall/purple/nocling,/area/maintenance/polovich/forest/rain)
"c" = (/turf/open/floor/plating/polovich/lightblue,/area/maintenance/polovich/forest/rain)
"d" = (/turf/open/floor/plating/polovich/greengryaz,/area/maintenance/polovich/forest/rain)
"e" = (/obj/structure/flora/ausbushes/zarosli/midnight,/turf/open/floor/plating/polovich/greengryaz,/area/maintenance/polovich/forest/rain)
"f" = (/turf/open/floor/plating/polovich/roots,/area/maintenance/polovich/forest/rain)
"g" = (/obj/structure/flora/tree/evil,/turf/open/floor/plating/polovich/roots,/area/maintenance/polovich/forest/rain)
"h" = (/turf/open/floor/plating/polovich/asteroid/snow/river/nevado_surface/shallow/ankle,/area/maintenance/polovich/forest/rain)
"i" = (/turf/open/floor/plating/polovich/greendirtevil,/area/maintenance/polovich/forest/rain)
"j" = (/turf/open/floor/plating/polovich/dirt/dark/gryazka,/area/maintenance/polovich/forest/rain)
"k" = (/obj/structure/flora/ausbushes/zarosli/midnight,/turf/open/floor/plating/polovich/lightblue,/area/maintenance/polovich/forest/rain)
"l" = (/obj/structure/flora/ausbushes/bushka,/turf/open/floor/plating/polovich/asteroid/snow/river/nevado_surface/shallow/ankle,/area/maintenance/polovich/forest/rain)
"m" = (/obj/structure/flora/ausbushes/zarosli/midnight,/turf/open/floor/plating/polovich/greendirtevil,/area/maintenance/polovich/forest/rain)
"n" = (/obj/machinery/gibber,/turf/open/floor/plating/polovich/lightblue,/area/maintenance/polovich/forest/rain)
"o" = (/obj/structure/flora/ausbushes/zarosli/midnight,/turf/open/floor/plating/polovich/roots,/area/maintenance/polovich/forest/rain)
"p" = (/turf/open/floor/plating/polovich/asteroid/snow/river/nevado_surface/shallow/ankle,/area/space)
"q" = (/obj/structure/flora/ausbushes/zarosli/midnight,/turf/open/floor/plating/polovich/dirt/dark/gryazka,/area/maintenance/polovich/forest/rain)
"r" = (/obj/structure/flora/stump,/turf/open/floor/plating/polovich/roots,/area/maintenance/polovich/forest/rain)
"s" = (/obj/structure/railing{dir = 8},/turf/open/floor/plating/polovich/greengryaz,/area/maintenance/polovich/forest/rain)
"t" = (/obj/structure/barricade/flora/crystal/green,/turf/open/floor/plating/polovich/greengryaz{randomgenerate = 0},/area/maintenance/polovich/forest/rain)
"u" = (/obj/structure/fluff/narrator/forest/carehouse,/turf/open/floor/plating/polovich/greengryaz{randomgenerate = 0},/area/maintenance/polovich/forest/rain)
"v" = (/obj/structure/railing{dir = 4},/turf/open/floor/plating/polovich/roots,/area/maintenance/polovich/forest/rain)
"w" = (/obj/structure/railing{dir = 8},/turf/open/floor/plating/polovich/roots,/area/maintenance/polovich/forest/rain)
"x" = (/obj/structure/flora/ausbushes/crystal,/turf/open/floor/plating/polovich/greengryaz{randomgenerate = 0},/area/maintenance/polovich/forest/rain)
"y" = (/turf/open/floor/plating/polovich/greengryaz{randomgenerate = 0},/area/maintenance/polovich/forest/rain)
"z" = (/turf/closed/wall/mineral/wood/nocling,/area/maintenance/polovich/forest)
"A" = (/obj/machinery/door/keycard/denominator/podozl/akt/carehouse,/turf/open/floor/plating/polovich/logsgreen,/area/maintenance/polovich/forest)
"B" = (/obj/structure/flora/tree/evil,/turf/open/floor/plating/polovich/greendirtevil,/area/maintenance/polovich/forest/rain)
"C" = (/turf/open/floor/plating/polovich/logsgreen,/area/maintenance/polovich/forest)
"D" = (/turf/open/floor/plating/polovich/logsgreen/two,/area/maintenance/polovich/forest)
"E" = (/obj/structure/lampwall/service/directional/north,/turf/open/floor/plating/polovich/logsgreen,/area/maintenance/polovich/forest)
"F" = (/obj/structure/fluff/statueiron/seond,/turf/open/floor/plating/polovich/logsgreen/two,/area/maintenance/polovich/forest)
"H" = (/turf/open/floor/low_wall/window,/area/maintenance/polovich/forest)
"I" = (/turf/open/floor/plating/polovich/logsgreen{dir = 8},/area/maintenance/polovich/forest)
"J" = (/obj/effect/spawner/random/structure/maphelp/fire/inferno/ten/magic,/turf/open/floor/plating/polovich/dirt/dark/gryazka,/area/maintenance/polovich/forest/rain)
"K" = (/obj/structure/flora/tree/evil,/turf/open/floor/plating/polovich/lightblue,/area/maintenance/polovich/forest/rain)
"L" = (/obj/structure/flora/tree/evil,/turf/open/floor/plating/polovich/greengryaz,/area/maintenance/polovich/forest/rain)
"M" = (/obj/structure/flora/ausbushes/bushka,/turf/open/floor/plating/polovich/asteroid/snow/river/nevado_surface/shallow/ankle,/area/space)
"N" = (/obj/structure/flora/tree/evil,/turf/open/floor/plating/polovich/dirt/dark/gryazka,/area/maintenance/polovich/forest/rain)
"O" = (/obj/effect/spawner/random/structure/maphelp/fire/inferno/ten/magic,/turf/open/floor/plating/polovich/lightblue,/area/maintenance/polovich/forest/rain)
"P" = (/obj/structure/flora/ausbushes/zarosli/midnight,/turf/open/floor/plating/polovich/asteroid/snow/river/nevado_surface/shallow/ankle,/area/maintenance/polovich/forest/rain)
"Q" = (/turf/open/floor/plating/polovich/dirt/dark/bright,/area/maintenance/polovich/forest/rain)
"R" = (/obj/machinery/gibber,/turf/open/floor/plating/polovich/greendirtevil,/area/maintenance/polovich/forest/rain)
"S" = (/obj/effect/spawner/random/structure/maphelp/fire/inferno/ten/magic,/turf/open/floor/plating/polovich/greendirtevil,/area/maintenance/polovich/forest/rain)
"T" = (/obj/structure/flora/ausbushes/zarosli/midnight,/turf/open/floor/plating/polovich/asteroid/snow/river/nevado_surface/shallow/ankle,/area/space)
"U" = (/obj/structure/sign/poster/official/podozl,/turf/closed/wall/purple/nocling,/area/maintenance/polovich/forest/rain)
"V" = (/turf/closed/wall/purple,/area/maintenance/polovich/forest/rain)

(1,1,1) = {"
bbbbbbbbbbbbbbbbbbbbbbbbbbbbbbbbbbbbbbbbbbbbbbbbbbbbbbbbbbbbbbbbbbbbbbbbbbbbbbbbbbbbbbbbbbbbbbbbbbbbbbbbbbbbbbbbbbbbbbbbbbbbbbbbbb
bbbbbbbbbbbbbbbbbbbbbbbbbbbbbbbbbbbbbbbbbbbbbbbbbbbbbbbbbbbbbbbbbbbbbbbbbbbbbbbbbbbbbbbbbbbbbbbbbbbbbbbbbbbbbbbbbbbbbbbbbbbbbbbbbb
bbbbbbbbbbbbbbbbbbbbbbbbbbbbbbbbbbbbbbbbbbbbbbbbbbbbbbbbbbbbbbbbbbbbbbbbbbbbbbbbbbbbbbbbbbbbbbbbbbbbbbbbbbbbbbbbbbbbbbbbbbbbbbbbbb
bbbbbbbbbbbbbbbbbbbbbbbbbbbbbbbbbbbbbbbbbbbbbbbbbbbbbbbbbbbbbbbbbbbbbbbbbbbbbbbbbbbbbbbbbbbbbbbbbbbbbbbbbbbbbbbbbbbbbbbbbbbbbbbbbb
bbbbbbbbbbbbbbbbbbbbbbbbbbbbbbbbbbbbbbbbbbbbbbbbbbbbbbbbbbbbbbbbbbbbbbbbbbbbbbbbbbbbbbbbbbbbbbbbbbbbbbbbbbbbbbbbbbbbbbbbbbbbbbbbbb
bbbbbbbbbbbbbbbbbbbbbbbbbbbbbbbbbbbbbbbbbbbbbbbbbbbbbbbbbbbbbbbbbbbbbbbbbbbbbbbbbbbbbbbbbbbbbbbbbbbbbbbbbbbbbbbbbbbbbbbbbbbbbbbbbb
bbbbbbbbbbbbbbbbbbbbbbbbbbbbbbbbbbbbbbbbbbbbbbbbbbbbbbbbbbbbbbbbbbbbbbbbbbbbbbbbbbbbbbbbbbbbbbbbbbbbbbbbbbbbbbbbbbbbbbbbbbbbbbbbbb
bbbbbbbbbbbbbbbbbbbbbbbbbbbbbbbbbbbbbbbbbbbbbbbbbbbbbbbbbbbbbbbbbbbbbbbbbbbbbbbbbbbbbbbbbbbbbbbbbbbbbbbbbbbbbbbbbbbbbbbbbbbbbbbbbb
bbbbbbbbbbbbbbbbbbbbbbbbbbbbbbbbbbbbbbbbbbbbbbbbbbbbbbbbbbbbbbbbbbbbbbbbbbbbbbbbbbbbbbbbbbbbbbbbbbbbbbbbbbbbbbbbbbbbbbbbbbbbbbbbbb
bbbbbbbbbbbbbbbbbbbbbbbbbbbbbbbbbbbbbbbbbbbbbbbbbbbbbbbbbbbbbbbbbbbbbbbbbbbbbbbbbbbbbbbbbbbbbbbbbbbbbbbbbbbbbbbbbbbbbbbbbbbbbbbbbb
bbbbbbbbbbbbbbbbbbbbbbbbbbbbbbbbbbbbbbbbbbbbbbbbbbbbbbbbbbbbbbbbbbbbbbbbbbbbbbbbbbbbbbbbbbbbbbbbbbbbbbbbbbbbbbbbbbbbbbbbbbbbbbbbbb
bbbbbbbbbbbbbbbbbbbbbbbbbbbbbbbbbbbbbbbbbbbbbbbbbbbbbbbbbbbbbbbbbbbbbbbbbbbbbbbbbbbbbbbbbbbbbbbbbbbbbbbbbbbbbbbbbbbbbbbbbbbbbbbbbb
bbbbbbbbbbbbbbbbbbbbbbbbbbbbbbbbbbbbbbbbbbbbbbbbbbbbbbbbbbbbbbbbbbbbbbbbbbbbbbbbbbbbbbbbbbbbbbbbbbbbbbbbbbbbbbbbbbbbbbbbbbbbbbbbbb
bbbbbbbbbbbbbbbbbbbbbbbbbbbbbbbbbbbbbbbbbbbbbbbbbbbbbbbbbbbbbbbbbbbbbbbbbbbbbbbbbbbbbbbbbbbbbbbbbbbbbbbbbbbbbbbbbbbbbbbbbbbbbbbbbb
bbbbbbbbbbbbbbbbbbbbbbbbbbbbbbbbbbbbbbbbbbbbbbbbbbbbbbbbbbbbbbbbbbbbbbbbbbbbbbbbbbbbbbbbbbbbbbbbbbbbbbbbbbbbbbbbbbbbbbbbbbbbbbbbbb
bbbbbbbbbbbbbbbbbbbbbbbbbbbbbbbbbbbbbbbbbbbbbbbbbbbbbbbbbbbbbbbbbbbbbbbbbbbbbbbbbbbbbbbbbbbbbbbbbbbbbbbbbbbbbbbbbbbbbbbbbbbbbbbbbb
bbbbbbbbbbbbbbbbbbbbbbbbbbbbbbbbbbbbbbbbbbbbbbbbbbbbbbbbbbbbbbbbbbbbbbbbbbbbbbbbbbbbbbbbbbbbbbbbbbbbbbbbbbbbbbbbbbbbbbbbbbbbbbbbbb
bbbbbbbbbbbbbbbbbbbbbbbbbbbbbbbbbbbbbbbbbbbbbbbbbbbbbbbbbbbbbbbbbbbbbbbbbbbbbbbbbbbbbbbbbbbbbbbbbbbbbbbbbbbbbbbbbbbbbbbbbbbbbbbbbb
bbbbbbbbbbbbbbbbbbbbbbbbbbbbbbbbbbbbbbbbbbbbbbbbbbbbbbbbbbbbbbbbbbbbbbbbbbbbbbbbbbbbbbbbbbbbbbbbbbbbbbbbbbbbbbbbbbbbbbbbbbbbbbbbbb
bbbbbbbbbbbbbbbbbbbbbbbbbbbbbbbbbbbbbbbbbbbbbbbbbbbbbbbbbbbbbbbbbbbbbbbbbbbbbbbbbbbbbbbbbbbbbbbbbbbbbbbbbbbbbbbbbbbbbbbbbbbbbbbbbb
bbbbbbbbbbbbbbbbbbbbbbbbbbbbbbbbbbbbbbbbbbbbbbbbbbbbbbbbbbbbbbbbbbbbbbbbbbbbbbbbbbbbbbbbbbbbbbbbbbbbbbbbbbbbbbbbbbbbbbbbbbbbbbbbbb
bbbbbbbbbbbbbbbbbbbbbbbbbbbbbbbbbbbbbbbbbbbbbbbbbbbbbbbbbbbbbbbbbbbbbbbbbbbbbbbbbbbbbbbbbbbbbbbbbbbbbbbbbbbbbbbbbbbbbbbbbbbbbbbbbb
bbbbbbbbbbbbbbbbbbbbbbbbbbbbbbbbbbbbbbbbbbbbbbbbbbbbbbbbbbbbbbbbbbbbbbbbbbbbbbbbbbbbbbbbbbbbbbbbbbbbbbbbbbbbbbbbbbbbbbbbbbbbbbbbbb
bbbbbbbbbbbbbbbbbbbbbbbbbbbbbbbbbbbbbbbbbbbbbbbbbbbbbbbbbbbbbbbbbbbbbbbbbbbbbbbbbbbbbbbbbbbbbbbbbbbbbbbbbbbbbbbbbbbbbbbbbbbbbbbbbb
bbbbbbbbbbbbbbbbbbbbbbbbbbbbbbbbbbbbbbbbbbbbbbbbbbbbbbbbbbbbbbbbbbbbbbbbbbbbbbbbbbbbbbbbbbbbbbbbbbbbbbbbbbbbbbbbbbbbbbbbbbbbbbbbbb
bbbbbbbbbbbbbbbbbbbbbbbbbbbbbbbbbbbbbbbbbbbbbbbbbbbbbbbbbbbbbbbbbbbbbbbbbbbbbbbbbbbbbbbbbbbbbbbbbbbbbbbbbbbbbbbbbbbbbbbbbbbbbbbbbb
bbbbbbbbbbbbbbbbbbbbbbbbbbbbbbbbbbbbbbbbbbbbbbbbbbbbbbbbbbbbbbbbbbbbbbbbbbbbbbbbbbbbbbbbbbbbbbbbbbbbbbbbbbbbbbbbbbbbbbbbbbbbbbbbbb
bbbbbbbbbbbbbbbbbbbbbbbbbbbbbbbbbbbbbbbbbbbbbbbbbbbbbbbbbbbbbbbbbbbbbbbbbbbbbbbbbbbbbbbbbbbbbbbbbbbbbbbbbbbbbbbbbbbbbbbbbbbbbbbbbb
bbbbbbbbbbbbbbbbbbbbbbbbbbbbbbbbbbbbbbbbbbbbbbbbbbbbbbbbbbbbbbbbbbbbbbbbbbbbbbbbbbbbbbbbbbbbbbbbbbbbbbbbbbbbbbbbbbbbbbbbbbbbbbbbbb
bbbbbbbbbbbbbbbbbbbbbbbbbbbbbbbbbbbbbbbbbbbbbbbbbbbbbbbbbbbbbbbbbbbbbbbbbbbbbbbbbbbbbbbbbbbbbbbbbbbbbbbbbbbbbbbbbbbbbbbbbbbbbbbbbb
bbbbbbbbbbbbbbbbbbbbbbbbbbbbbbbbbbbbbbbbbbbbbbbbbbbbbbbbbbbbbbbbbbbbbbbbbbbbbbbbbbbbbbbbbbbbbbbbbbbbbbbbbbbbbbbbbbbbbbbbbbbbbbbbbb
bbbbbbbbbbbbbbbbbbbbbbbbbbbbbbbbbbbbbbbbbbbbbbbbbbbbbbbbbbbbbbbbbbbbbbbbbbbbbbbbbbbbbbbbbbbbbbbbbbbbbbbbbbbbbbbbbbbbbbbbbbbbbbbbbb
bbbbbbbbbbbbbbbbbbbbbbbbbbbbbbbbbbbbbbbbbbbbbbbbbbbbbbbbbbbbbbbbbbbbbbbbbbbbbbbbbbbbbbbbbbbbbbbbbbbbbbbbbbbbbbbbbbbbbbbbbbbbbbbbbb
bbbbbbbbbbbbbbbbbbbbbbbbbbbbbbbbbbbbbbbbbbbbbbbbbbbbbbbbbbbbbbbbbbbbbbbbbbbbbbbbbbbbbbbbbbbbbbbbbbbbbbbbbbbbbbbbbbbbbbbbbbbbbbbbbb
bbbbbbbbbbbbbbbbbbbbbbbbbbbbbbbbbbbbbbbbbbbbbbbbbbbbbbbbbbbbbbbbbbbbbbbbbbbbbbbbbbbbbbbbbbbbbbbbbbbbbbbbbbbbbbbbbbbbbbbbbbbbbbbbbb
bbbbbbbbbbbbbbbbbbbbbbbbbbbbbbbbbbbbbbbbbbbbbbbbbbbbbbbbbbbbbbbbbbbbbbbbbbbbbbbbbbbbbbbbbbbbbbbbbbbbbbbbbbbbbbbbbbbbbbbbbbbbbbbbbb
bbbbbbbbbbbbbbbbbbbbbbbbbbbbbbbbbbbbbbbbbbbbbbbbbbbbbbbbbbbbbbbbbbbbbbbbbbbbbbbbbbbbbbbbbbbbbbbbbbbbbbbbbbbbbbbbbbbbbbbbbbbbbbbbbb
bbbbbbbbbbbbbbbbbbbbbbbbbbbbbbbbbbbbbbbbbbbbbbbbbbbbbbbbbbbbbbbbbbbbbbbbbbbbbbbbbbbbbbbbbbbbbbbbbbbbbbbbbbbbbbbbbbbbbbbbbbbbbbbbbb
bbbbbbbbbbbbbbbbbbbbbbbbbbbbbbbbbbbbbbbbbbbbbbbbbbbbbbbbbbbbbbbbbbbbbbbbbbbbbbbbbbbbbbbbbbbbbbbbbbbbbbbbbbbbbbbbbbbbbbbbbbbbbbbbbb
bbbbbbbbbbbbbbbbbbbbbbbbbbbbbbbbbbbbbbbbbbbbbbbbbbbbbbbbbbbbbbbbbbbbbbbbbbbbbbbbbbbbbbbbbbbbbbbbbbbbbbbbbbbbbbbbbbbbbbbbbbbbbbbbbb
bbbbbbbbbbbbbbbbbbbbbbbbbbbbbbbbbbbbbbbbbbbbbbbbbbbbbbbbbbbbbbbbbbbbbbbbbbbbbbbbbbbbbbbbbbbbbbbbbbbbbbbbbbbbbbbbbbbbbbbbbbbbbbbbbb
bbbbbbbbbbbbbbbbbbbbbbbbbbbbbbbbbbbbbbbbbbbbbbbbbbbbbbbbbbbbbbbbbbbbbbbbbbbbbbbbbbbbbbbbbbbbbbbbbbbbbbbbbbbbbbbbbbbbbbbbbbbbbbbbbb
bbbbbbbbbbbbbbbbbbbbbbbbbbbbbbbbbbbbbbbbbbbbbbbbbbbbbbbbbbbbbbbbbbbbbbbbbbbbbbbbbbbbbbbbbbbbbbbbbbbbbbbbbbbbbbbbbbbbbbbbbbbbbbbbbb
bbbbbbbbbbbbbbbbbbbbbbbbbbbbbbbbbbbbbbbbbbbbbbbbbbbbbbbbbbbbbbbbbbbbbbbbbbbbbbbbbbbbbbbbbbbbbbbbbbbbbbbbbbbbbbbbbbbbbbbbbbbbbbbbbb
bbbbbbbbbbbbbbbbbbbbbbbbbbbbbbbbbbbbbbbbbbbbbbbbbbbbbbbbbbbbbbbbbbbbbbbbbbbbbbbbbbbbbbbbbbbbbbbbbbbbbbbbbbbbbbbbbbbbbbbbbbbbbbbbbb
bcddddcedddfghhiccgficddcjhjidgdddddcdddgccicdgiiddeeeddcdjjjjffddcdeeeeiidddiiikkgceiigddiiidgclhllhldbbbbbbbbbbbbbbbbbbbbbbbbbbb
bdiccidkddiiijlciddfgddgdhlhgffdiildgfcddiiddeddideeeddfgfdcccgddddgfffeefgiccgccdddeiihddiccccdhlhllhdbbbbbbbbbbbbbbbbbbbbbbbbbbb
bdikcigedgfiidccffcddddddhhhcddciiiicdcddddddeckmdeeegfihhdddifdddifiggeeddddddddhheeeehdfdfgfcdlhhhjjdbbbbbbbbbbbbbbbbbbbbbbbbbbb
bgckcffeefdifdekgfdddddddccccedgddiiddhdddiggeeedcdidfjhllfgddddfgdcddeedcdffdhidgceedkhdgddddcgidjjjfgbbbbbbbbbbbbbbbbbbbbbbbbbbb
bdckcgekeeidgdedccdcdgfiicgfeeedhhddddddgfdeeeeefgdiddjhhlhlhjcddfdncddmdiigfdlddccefgcciddddddffdiffcfbbbbbbbbbbbbbbbbbbbbbbbbbbb
bfgeeeegddddodmidddeedfgidddeeddhlhfgddddccdeffeefddddccjjdhjjciiiccdddidhhhhllcdccmidcccddfgdeefdigfcdbbbbbbbbbbbbbbbbbbbbbbbbbbb
bgdimedfddddeogidddeeiidddeeeegdfhjjjddddccimgfmedfdieddiiicecciiicdgddfdhlljjdfgfdmiddddgfifemfgdiidcdbbbbbbbbbbbbbbbbbbbbbbbbbbb
bdcijjiidcddefeddfmmgfcdddckedddgjjhhdddfddiiffmccgdimkccgffeckgfiddfddgfhljjcdcdddiiidfdfiiddmfdlljjddbbbbbbbbbbbbbbbbbbbbbbbbbbb
bdfgllhidfgeemeegfmkfcffgdcckdddcdjhhgidgfccdgdddcceemdccddgeeefdcdfddccchljddeeeiigfddgdddifgmcdflljffbbbbbbbbbbbbbbbbbbbbbbbbbbb
bdddhlhcgfdddekchhheddgddddgfdddddigdkkkddkkdfdgfdcdddddeeeeekkddddgdeddhhhhhhheeiidccjhddicfdecgfhljfgbbbbbbbbbbbbbbbbbbbbbbbbbbb
bcfihlljddiddkgfllddddccdidddddgdiiddkkkemmiccdfgcccfgfddddmekkdgiideediigjjdegkkddcccjjjdfccdddllhdcffbbbbbbbbbbbbbbbbbbbbbbbbbbb
bgffhhhfgfdddkffdjgfddcgddiiddddddccdedgemmifcddifffcfdiidfgfeeddiidegfiifcdfefkkdgccdfgddgfcdddjjfgfdfbbbbbbbbbbbbbbbbbbbbbbbbbbb
bkdgjhjddiiedmdcccfiiddddgoeegdcdddcgfddddfdgdhdccgcccdigchjdkeddddiiffdddcdgekkddfddddiccidcdfgcccdddgbbbbbbbbbbbbbbbbbbbbbbbbbbb
becfjjjccimeogfccciddgfddddeefdidmidddgfdfgcfdhjccdeefdifhhjdddgddddddfgidfddidccddddcdigfmeedffidddcdfbbbbbbbbbbbbbbbbbbbbbbbbbbb
beeeeddfcdgedffcgfgdeedddifgcdceeegffdfccddcdfjjdeemegdijhhddiifcgfcdddddfgfdddfdiigdddddeeedfddddgfdddbbbbbbbbbbbbbbbbbbbbbbbbbbb
bmfoddfgddfddddddddeeeddcidjjdcedmdfgdddddidfgjhdddmiiedjjhgdiccdfddcddmeddddddgfdiffgddmmmeegfhcdiidddbbbbbbbbbbbbbbbbbbbbbbbbbbb
bkgeeccidiidffijjjffeidgcddjhddgfeeecddddgichhhhcgffickfgfhfddccdgddcfimekeiicccdhgdccdciiieecdlhdiiddcbbbbbbbbbbbbbbbbbbbbbbbbbbb
bkdemmedgdhhfgihhjgddiifgddlphcfdeeecddgifcchhhcccfgdkkffihhdgddifddfgfmeedifdllhhfdijhdfgdiciidddiidjjbbbbbbbbbbbbbbbbbbbbbbbbbbb
bcdemmedffllhhhllhhdgfidccdljhddddfciddfiikddgfdddddeeedddhhgfcdiidddddeedddgdlhjjjdimqeddfgiddgddkfgjhbbbbbbbbbbbbbbbbbbbbbbbbbbb
bddemmkkcjhhhjjlhcllddddcccdfgdiifgcgfdemmddiiddfgfeeeedfdhjfdddiccddccddgfdfccjgfddeefgdiifiddfcfkmjhhbbbbbbbbbbbbbbbbbbbbbbbbbbb
bddemmoedicdgfidcglfgiicccgcihhiiddcfddeeedfddiddddfeeecgdjjdddffgdfgfddddddddddcdddgfdfddcdddddcgeejjlbbbbbbbbbbbbbbbbbbbbbbbbbbb
bdigmmgeeecddicccfhjfdddcgfclhhjgfdffimmekfgddiddddgfccccdcddccgeedhdidddddicidffgcccdidcdddgdcccddejghbbbbbbbbbbbbbbbbbbbbbbbbbbb
bddfeefdedfdddcccfhjdddgffdccljjfddgfiiidkcjjfgcccdiddddirdddcifekcjiiddfgffgddddcccciidgfddfdckgedeifjbbbbbbbbbbbbbbbbbbbbbbbbbbb
bfcckdcncfgdfgcccgcddfcfcidcdlcccddddddgfhhhhjfdcddfdddsttidutviccccidfgcdfeeedddffjhlldiiiediikkedgjjdbbbbbbbbbbbbbbbbbbbbbbbbbbb
bgfdddgddifddfcccccffgcckcfgdhdfidfgddddhhhghjiidddgdddwxxyixxvifgcdgddfddeeeekcdfgjllccddeeeddjjhidjldbbbbbbbbbbbbbbbbbbbbbbbbbbb
bfcdjjjiiddddfgfdlhgddeeedidddfgiddfdgfgdhdfiiiidgdiccczzzAzzzzdddddfdgcdceemffddddchfdfgdegfcccddddfidbbbbbbbbbbbbbbbbbbbbbbbbbbb
bcddhljfgiiiddddjlljdimegdddgfddceeddcdddgddiiBidfddccczCCDECCzdddfdcdfccccdefgfcddlhgddeeeefcccgfdfgidbbbbbbbbbbbbbbbbbbbbbbbbbbb
bdddhllddiccddddjhlhdcdefcfccccggkeeccmeffdfddidddddcddzFDDDDDzdflghljgffdgfedddcdddhiidkkeegdcdfffdfcdbbbbbbbbbbbbbbbbbbbbbbbbbbb
bfgfjhldddfgdddddgfddgdedigiimmmeeeeccmeddfgdiidcdddcgdzIDDDDDHffhflljcdfdfcccddcdddddddckedddcddfgddchbbbbbbbbbbbbbbbbbbbbbbbbbbb
bdifcfddddddigfdcdiddddddiciddeeeedddeedcdhjcgdfdckedfdzIIIIIIzdjhllccccdddiiiihjdgfdddgdgdhddcdddihdcdbbbbbbbbbbbbbbbbbbbbbbbbbbb
beiccgddgdddiieddfddcccddiddddfdkcgfdeegdgfccfdfgckeddizzzzzzzzfjlhffcciidddfgdhhjcfddgfdfJhiidKddddlgdbbbbbbbbbbbbbbbbbbbbbbbbbbb
bemkciddfdieeeecgfddcieddidfgcgfkkdfgiddcddcccdddeeeeccgfeeemmfgjljgddfgdfgidiilhjccddiiddjhlLcddgdccimbbbbbbbbbbbbbbbbbbbbbbbbbbb
bimmdccccdeeedfccddfgfmgdcddddiiddddfigfdddgdddgimeidccdfgdededfjjjcdddfdcdidgdchjcgdiiicgchiddddfcdgdmbbbbbbbbbbbbbbbbbbbbbbbbbbb
bgfedcccgddeefgkkcidmemfdgddddimmdcdddddgiiigdddiiddgddddemmeeekidccddfdccddddccdddfdiidcfMhjeddddddckebbbbbbbbbbbbbbbbbbbbbbbbbbb
beeeddddffgeeckkkcddeemdgfdddcgcmedddgddfiiiddcciiddcdiiiliigddedfgddcgccdddfgccfdgfddgdccccckeddiiiccdbbbbbbbbbbbbbbbbbbbbbbbbbbb
bekegffdcddddijhmfgdeedddcjjghfgmedgffdidddgccccdgfdhhfgdhjjdikkecfdfdddccdeefddgdddddfddcKddeeLiigfgcibbbbbbbbbbbbbbbbbbbbbbbbbbb
beeejjgddfffdddiidfdfddiicjhlllliiddiddddemffdgdddcjlhhhhhhhcgeeecddfgfddgfeediiddekdddidccmmeefdiddccibbbbbbbbbbbbbbbbbbbbbbbbbbb
bmdjjhdcddgddfgdgfddgfdgiichhlhljdfgdedgdeeedcfdcgcjjhjjllhlcffefgcdiideefdmekddddmmdffgdddeeedcdidddddbbbbbbbbbbbbbbbbbbbbbbbbbbb
bmglhhfdddccddddidccccdfiiiiddlljcdddemdcdeeecgccfcccffjjjddcddddcddiidceeekeefgfdmmegcddddddffcgfddiiibbbbbbbbbbbbbbbbbbbbbbbbbbb
befhhhgiiicfgffgidccfgdfgdigdgfcddidddidcckeeccccdidcgccdgfgcdiidcfddicgfeemgfdiceemedccdfgidgfifdmgiiibbbbbbbbbbbbbbbbbbbbbbbbbbb
bKchjfcddccdcdddddgddfdddddddccdimgffdghcddddccccddgccccdiidddigicgcdicfdddmmddddeeeddiddffddidddemfdfdbbbbbbbbbbbbbbbbbbbbbbbbbbb
bccddddedgddljddldfdddidigfdiidgomfdfdfhjfgdfddgfddfccccdddgfddfddccdjhjfgfdeddgfcceffiiddddddccddiidgcbbbbbbbbbbbbbbbbbbbbbbbbbbb
bccigddeeddiijdddcdddiLdiccdddddfeeegdlhhfdigdffddddcgccgfdfeddiddddhhlhjdddedcddccigddgdddckegdddddddcbbbbbbbbbbbbbbbbbbbbbbbbbbb
bcdcdcgmeefiiigddcdddddedccdgddfgekediilhdcddddccdcccfgcdcmmegdjdddfgfhjfdciiddcdcdiiddffcgemefffgdckedbbbbbbbbbbbbbbbbbbbbbbbbbbb
bdicdkemeegddiiddgdcgoeeiigdddhddkgfdfgfjdddiddcgfddddidhgjhkkdhfgdddiiigcgiiddciccddddddccdddgidfdgomibbbbbbbbbbbbbbbbbbbbbbbbbbb
bgfddmeefdddcddgidddcemedddcdijidccdddddcccdiddccdiiidjjhcjjkkcdifiiidiifcfdgfccdcdccfgcdddddicciddcemmbbbbbbbbbbbbbbbbbbbbbbbbbbb
bfidccccgddccddiidddeegjdccddidigfdiiiiddccfgdddidcgcdjhhddkejddhdiigddddcddiidgfddkccdiddfdeiccdieeeeebbbbbbbbbbbbbbbbbbbbbbbbbbb
bdcgccccdddddfdcdgfdmmdhfgcdfgdifddiiiidgddiidcgkddfddjhhcdddhddddddfccgddfddiddffdkcddidfgckccddddkkifbbbbbbbbbbbbbbbbbbbbbbbbbbb
bdccddddiiddfgjjhiidmmdcdcddffcddddddgddfiiiidcfkedddddhhcfidifgcchccccfdfgfdddcgcemfgdlldfhedgfdddkccgbbbbbbbbbbbbbbbbbbbbbbbbbbb
bmiddfidiigdcjhhlddeeddiicidddgfddcddekddiidfgckkecdddghhcgcdhdfddfgiikeeccdfddckeeeffjhhhhheeeeiddkcddbbbbbbbbbbbbbbbbbbbbbbbbbbb
bmfdfgfdeffdcjhhddgddgddgdcdccddgicgfeeddiddccckeecddcdhdccddiidddieemmeeedfgdddemieddjjjlllkkefigdccdfbbbbbbbbbbbbbbbbbbbbbbbbbbb
begeedceeiiidlldgffiiddccdddccdddddoomeddgddccccdffddcdhgddiddddfdddemegdjjjljfffgddccddifdlkkfgdffdddgbbbbbbbbbbbbbbbbbbbbbbbbbbb
bekkmieeeiigildddidiiddccddgdddcgfdeeeedcfddccccdfgfddjhhdfdfefgfidgfdefijhhhjgdcccddddgfgdddddidddddiibbbbbbbbbbbbbbbbbbbbbbbbbbb
befiimecffdfcdgcccdidgffccdfdddiiddffiidjjjjNcccdccddiighdfgfeeffddfddddgjhhjjiiifdddddeecdccddiiiickdibbbbbbbbbbbbbbbbbbbbbbbbbbb
bebgbmebKcdccdfdccfgdcigcddddgfgddccgcidjhhhjddgdffddccchdcckkedddiddccddjjcffifgfdfgfeeeedccgfgiigkkefbbbbbbbbbbbbbbbbbbbbbbbbbbb
bbbbbbbbiiddddgdcgfoekmmediidfcdddccddgdfhhhjgjfdfgffgcccdddkcgddgccdccdddccgfifcddfccimeedcdfiieffmejfbbbbbbbbbbbbbbbbbbbbbbbbbbb
bbbOfibiiiidccddccfekcddddfgddddgfddddiighhhhhjddddddfddfgfddifdddcciiddimeeeeedcddccfgmedfcddddeePPjjhbbbbbbbbbbbbbbbbbbbbbbbbbbb
bfddfgddgfdfgciddddekkcgddddiiddidgfdfgidhhhhhjcdfdddickfmddgddddigfgiddifeeeeedcdgcdffdeigfddddehlPhhlbbbbbbbbbbbbbbbbbbbbbbbbbbb
bgfddfjjicddccddfgfkemiifjjjgfddddddccfdccjjjjjcgfccfgckemeddidgeeidddccdgdeemigfdfdddddddddiddccgchigfbbbbbbbbbbbbbbbbbbbbbbbbbbb
bhjjjfhjdemeedgiiffkdjjighhhddddgfddkkedccdgciccficcdgfofficceekeegfdddcddccdiiddddddddffdfgdddcccchiffbbbbbbbbbbbbbbbbbbbbbbbbbbb
blhhlghjgdmdeediiddddjhhhhclhjfiiidgoeefQQddcmddddddddeefgiddefgdmidgfgdddccgffgdccdgccigddddddgfdddgidbbbbbbbbbbbbbbbbbbbbbbbbbbb
blhdhlldfdegeegcRccddihhlccdjjgcekkkkeigQQddkmeddddgfdceddccfdffhdLckkiddfcdffdddccdffcdcdddeedidddcficbbbbbbbbbbbbbbbbbbbbbbbbbbb
bllgjjicdddeeidciccgfidfcgfiffjhjkcceeifiSffcddfgdmiiiiiddcgfddchdidokiddgdjjdddgddcdddddfgimeefgcdddicbbbbbbbbbbbbbbbbbbbbbbbbbbb
bffiiiicdgfeeicgiccdiigfccdifgccccifgdidddcgfddffemcciigcdffigfchgidgddddccjhdddhcddddiiidfimekdfcddfgfbbbbbbbbbbbbbbbbbbbbbbbbbbb
bgkmmddddffddicfcccididedciddccfccdddddjjccfehdekkekcdgfciddijhhhfddddddddjfhjfglccdddiiidddddfiddddeeebbbbbbbbbbbbbbbbbbbbbbbbbbb
bkkgmedfdkmeddccccgfeeeedddhdccgfdhdfgfhjceeediddfeedddddifgdjhhhhdiiiimgjjgljjhlhgddddgfddfdfgiddLcckebbbbbbbbbbbbbbbbbbbbbbbbbbb
bekfddcgckmdffjhdcceemimdcdjddddidccdiijjdddddiigfdeddgddiifccfjhhjifiimflhlllhhllfddfeecfgfdiojdddcgkebbbbbbbbbbbbbbbbbbbbbbbbbbb
bemeddcccfcdfglldccddfgmdfgidjhdccdgciiiddffdddiiiddddfddccccgfjjjjfgfeeekPhlihllddddgeecdddidkhdddgfldbbbbbbbbbbbbbbbbbbbbbbbbbbb
bgfifdddfgfdillhdgdddffedfccdiiicgdmiifgeeogjjcddddddiiddfccciiifgcfccikfgkddihidccckeemkddcgokmegiccddbbbbbbbbbbbbbbbbbbbbbbbbbbb
bfdigdcccccdiiiddddgdccedddddhjddhdmdddedckoTqgokkogfddfgfkkeeeddedcdUdceoefgfhigfcdeemmedddffcdificcdcbbbbbbbbbbbbbbbbbbbbbbbbbbb
bihdfcfccffeddgfgiiddddccddfgddcdedekddmmioihhPhccifccefddddideeeedddddiedddcfdidddddemidfgddddegdigfdgbbbbbbbbbbbbbbbbbbbbbbbbbbb
bffcekgfdigmedcdddddddiidiiidddidekkgommmoghllocddiicceecddfddgeeiiiidfgeddcddiddddiiddddgoddgkkfddccdebbbbbbbbbbbbbbbbbbbbbbbbbbb
bgfkemmediimkddccddcgfiidgiidfgedgfifediimmjljgcddddeeekcgdgfdfkkdgiidifddfgddidgcddicdddccddffcddddddebbbbbbbbbbbbbbbbbbbbbbbbbbb
bckedimkdfddcdfgdcdddfdddfdcddmkdemmekkeeogjhjfccdfgddekcfdddeekkdfdddiiiddddddddcdddcgfddcdcdfdfgfdeccbbbbbbbbbbbbbbbbbbbbbbbbbbb
bcidgfdcdgddddidmmeeeddLdddfgoegdeedifgcddcchcddddccddeccidccddccdddddcddfgffdddfccddhhhjeedigfdjiddegfbbbbbbbbbbbbbbbbbbbbbbbbbbb
bfcifcdfdiifgckkkkgemiiidcdddddfeeedimfeddcchdfgddgfcddgdcdgcdddddddfgcccckiiieogiiddlhljeeiiidjlifgeffbbbbbbbbbbbbbbbbbbbbbbbbbbb
bgfdddfgiiiccccqlcfdiiddddcdificddddgmeegfdgddiidfdeegffdgcccigdcdididdckeemgiedmmmmgjhjcddidddddcdekeebbbbbbbbbbbbbbbbbbbbbbbbbbb
bjjddddcccjgfgcqqddfgicddgcdcgcdigcddddddccdddiiigieefcddcldhiddhdgdddddgfeffdgfedkdehhfgoemogiddcdeekcbbbbbbbbbbbbbbbbbbbbbbbbbbb
bjlgfccckjjlccceeddifdccdfcddccdicccdddcccccdddccfdekelfgccdjjjjjddiiidiiiedddddeckmelhfoccefiiiffdddcgbbbbbbbbbbbbbbbbbbbbbbbbbbb
bllhdcgfkfhhcccimfddddfddgcddjjdhddeffgkkccgfdgccdeeeddddhddjhhjcdlifgdiiidddcdimgfiellhekkgfddigcccccfbbbbbbbbbbbbbbbbbbbbbbbbbbb
bjhhiifckgllcgcidgccdfgdiddhhlhhlhdmgffeeidfddfdcddddgfiiiddhlheehjjdddddddekccddddigcllcddefdeefccccddbbbbbbbbbbbbbbbbbbbbbbbbbbb
bdllhhimeehjiiidddiddddiiiccjlgiddemmekkdiiidddicdgdgqgfgddccddemddhidddgfeekgcccdddfdcdcddeeeeedkgccddbbbbbbbbbbbbbbbbbbbbbbbbbbb
bgcdccdemegddddgiiccdffccdigfhicgfkedfgkdfgiddgjjjdkeqeeeigcchfokkgdmeiiiffddfdidfddiddfffdoekkmeefdifdbbbbbbbbbbbbbbbbbbbbbbbbbbb
bicdcgceeddcdddfdicciigccdifdlddddieddcccgdcdccjljfgckggdiffidggmmdeeeddfgiiddddfgiidddfgifgfckkdedigfVbbbbbbbbbbbbbbbbbbbbbbbbbbb
bbbbbbbbbbbbbbbbbbbbbbbbbbbbbbbbbbbbbbbbbbbbbbbbbbbbbbbbbbbbbbbbbbbbbbbbbbbbbbbbbbbbbbbbbbbbbbbbbbbbbbbbbbbbbbbbbbbbbbbbbbbbbbbbbb
"}
